Timestamp,MemTotal,MemFree,Buffers,Cached,SwapCached,Active,Inactive,Active(anon),Inactive(anon),Active(file),Inactive(file),SwapTotal,SwapFree,AnonPages,Mapped,Shmem,CommitLimit,Committed_AS
2024-11-20 04:53:18,1858332,1075756,596,284364,16968,110716,196208,73928,47788,36788,148420,520908,359648,120360,143228,516,1450072,22194528
2024-11-20 04:53:18,1858332,1075756,596,284364,16968,110716,196208,73928,47788,36788,148420,520908,359648,120360,143228,516,1450072,22194528
2024-11-20 04:53:18,1858332,1075756,596,284364,16968,110716,196208,73928,47788,36788,148420,520908,359648,120360,143228,516,1450072,22194528
2024-11-20 04:53:18,1858332,1075756,596,284364,16968,110716,196208,73928,47788,36788,148420,520908,359648,120360,143228,516,1450072,22194528
2024-11-20 04:53:18,1858332,1075756,596,284364,16968,110716,196208,73928,47788,36788,148420,520908,359648,120360,143228,516,1450072,22194528
2024-11-20 04:53:18,1858332,1075756,596,284364,16968,110716,196208,73928,47788,36788,148420,520908,359648,120360,143228,516,1450072,22194528
2024-11-20 04:53:18,1858332,1075756,596,284364,16968,110716,196208,73928,47788,36788,148420,520908,359648,120360,143228,516,1450072,22194528
2024-11-20 04:53:18,1858332,1075756,596,284364,16968,110716,196208,73928,47788,36788,148420,520908,359648,120360,143228,516,1450072,22194528
2024-11-20 04:53:18,1858332,1075756,596,284364,16968,110716,196208,73928,47788,36788,148420,520908,359648,120360,143228,516,1450072,22194528
2024-11-20 04:53:18,1858332,1075756,596,284364,16968,110716,196208,73928,47788,36788,148420,520908,359648,120360,143228,516,1450072,22194528
2024-11-20 04:53:18,1858332,1075756,596,284364,16968,110716,196208,73928,47788,36788,148420,520908,359648,120360,143228,516,1450072,22194528
2024-11-20 04:53:20,1858332,988248,940,320680,17008,168788,224304,123936,47336,44852,176968,520908,359676,170188,152060,520,1450072,22398728
2024-11-20 04:53:22,1858332,722816,940,436320,17008,318184,339788,273332,47324,44852,292464,520908,359676,319196,152228,520,1450072,23202052
2024-11-20 04:53:24,1858332,32520,372,571244,16092,940700,410652,705436,174168,235264,236484,520908,357820,878060,152252,520,1450072,23201976
2024-11-20 04:53:27,1858332,49772,72,178316,16092,1012828,326580,973724,287268,39104,39312,520908,357816,1258984,126448,520,1450072,22204708
2024-11-20 04:53:29,1858332,42532,176,187704,16252,1002368,347832,962632,299636,39736,48196,520908,360372,1260696,128852,572,1450072,20282276
2024-11-20 04:53:31,1858332,38640,176,187688,16256,1006808,347940,967072,299624,39736,48316,520908,360380,1265088,128852,572,1450072,20282360
2024-11-20 04:53:34,1858332,39968,184,192920,16256,1003268,351760,963528,298464,39740,53296,520908,360468,1260288,130344,572,1450072,20282372
2024-11-20 04:53:36,1858332,41332,184,191292,16256,1001976,352160,962228,300284,39748,51876,520908,360472,1261064,130352,572,1450072,20282372
2024-11-20 04:53:38,1858332,41704,192,192136,16260,998656,356668,958908,303808,39748,52860,520908,360556,1261116,130632,572,1450072,20282336
2024-11-20 04:53:41,1858332,42352,192,192452,16260,997372,358928,957536,305960,39836,52968,520908,360560,1261588,131376,572,1450072,20282548
2024-11-20 04:53:43,1858332,40672,196,192448,16260,998836,358952,959000,305956,39836,52996,520908,360608,1263116,132848,572,1450072,22202576
2024-11-20 04:53:46,1858332,39036,268,205480,16260,997292,377276,951796,317260,45496,60016,520908,358472,1267632,146176,572,1450072,24124272
2024-11-20 04:53:49,1858332,36596,404,203760,16248,1007868,371276,956168,318828,51700,52448,520908,355036,1273460,151244,572,1450072,24125532
2024-11-20 04:53:51,1858332,36536,524,201696,16248,1009484,369748,958228,318596,51256,51152,520908,354212,1275312,151924,572,1450072,24125804
2024-11-20 04:53:54,1858332,54328,500,185912,15288,982808,358500,937804,317064,45004,41436,520908,351248,1253236,139804,572,1450072,20282524
2024-11-20 04:53:56,1858332,47456,508,193080,15288,982780,365836,937776,317064,45004,48772,520908,351260,1253256,140472,572,1450072,20282588
2024-11-20 04:53:59,1858332,47308,508,193080,15288,983100,365824,938096,317052,45004,48772,520908,351260,1253548,140104,572,1450072,20282364
2024-11-20 04:54:01,1858332,46124,508,194096,15288,983776,366424,938772,316660,45004,49764,520908,351276,1253772,140416,572,1450072,20282564
2024-11-20 04:54:04,1858332,46248,508,194096,15288,983916,366436,938912,316648,45004,49788,520908,351276,1253668,140416,572,1450072,20282444
2024-11-20 04:54:06,1858332,45524,496,197264,15072,985472,368180,940464,315240,45008,52940,520908,350736,1253872,140552,572,1450072,20282488
2024-11-20 04:54:09,1858332,45752,496,197480,15072,985368,368380,940360,315236,45008,53144,520908,350736,1253876,140716,572,1450072,20282560
2024-11-20 04:54:11,1858332,45188,496,197480,15072,985600,368392,940592,315236,45008,53156,520908,350736,1254112,140656,572,1450072,20282500
2024-11-20 04:54:14,1858332,45068,496,197480,15072,985716,368392,940708,315236,45008,53156,520908,350736,1254016,140900,572,1450072,20282420
2024-11-20 04:54:16,1858332,44992,496,197480,15072,985912,368384,940904,315228,45008,53156,520908,350736,1254416,140656,572,1450072,20282584
2024-11-20 04:54:19,1858332,45024,496,197480,15072,985796,368384,940788,315228,45008,53156,520908,350736,1254424,140716,572,1450072,20282368
2024-11-20 04:54:21,1858332,44768,496,197480,15072,986016,368384,941008,315228,45008,53156,520908,350736,1254540,140768,572,1450072,20282452
2024-11-20 04:54:24,1858332,44420,496,197480,15072,986412,368380,941404,315224,45008,53156,520908,350736,1255000,140660,572,1450072,20282368
2024-11-20 04:54:27,1858332,43292,496,198336,15072,986900,369212,941892,315220,45008,53992,520908,350736,1255568,140856,572,1450072,20282512
2024-11-20 04:54:29,1858332,49224,496,198336,15072,980672,368908,935664,314896,45008,54012,520908,350736,1248876,140160,572,1450072,20282576
2024-11-20 04:54:32,1858332,49336,496,198336,15072,981080,368908,936072,314896,45008,54012,520908,350736,1249280,139920,572,1450072,20282324
2024-11-20 04:54:34,1858332,48784,496,198580,15072,981556,369152,936548,314896,45008,54256,520908,350736,1249532,140116,572,1450072,20282248
2024-11-20 04:54:37,1858332,48400,496,198580,15072,981904,369160,936896,314904,45008,54256,520908,350744,1250192,140140,572,1450072,20282500
2024-11-20 04:54:40,1858332,48316,504,198612,15072,982080,369200,937072,314904,45008,54296,520908,350744,1250216,139936,572,1450072,20282348
2024-11-20 04:54:42,1858332,48272,504,198612,15072,982260,369200,937252,314904,45008,54296,520908,350744,1250476,140128,572,1450072,20282500
2024-11-20 04:54:45,1858332,48172,504,198612,15072,982136,369200,937128,314904,45008,54296,520908,350744,1250320,140120,572,1450072,20282424
2024-11-20 04:54:47,1858332,47532,504,198716,15072,982644,369304,937636,314904,45008,54400,520908,350744,1250844,140136,572,1450072,20282540
2024-11-20 04:54:50,1858332,47424,504,198812,15072,982536,369400,937528,314904,45008,54496,520908,350744,1250636,140140,572,1450072,20282572
2024-11-20 04:54:52,1858332,47292,504,198812,15072,983056,369400,938048,314904,45008,54496,520908,350744,1251348,140324,572,1450072,20282492
2024-11-20 04:54:55,1858332,46908,504,198812,15072,983260,369396,938252,314900,45008,54496,520908,350744,1251416,140148,572,1450072,20282272
2024-11-20 04:54:57,1858332,45828,528,197896,15068,986248,368012,941232,314448,45016,53564,520908,350660,1254308,143104,572,1450072,22203792
2024-11-20 04:55:00,1858332,42676,548,198960,14984,990328,369492,945296,314984,45032,54508,520908,350204,1258856,146592,572,1450072,24124404
2024-11-20 04:55:03,1858332,38040,356,196512,14628,1000016,365504,951500,317052,48516,48452,520908,349432,1267300,146152,564,1450072,24125536
2024-11-20 04:55:06,1858332,60760,432,181100,13316,981332,350720,937652,312812,43680,37908,520908,348440,1249664,135472,576,1450072,20282428
2024-11-20 04:55:08,1858332,49176,432,193604,13316,980060,364528,937588,312816,42472,51712,520908,348456,1249676,136480,572,1450072,20282396
2024-11-20 04:55:11,1858332,48668,440,193600,13316,980960,364052,937972,312816,42988,51236,520908,348456,1250448,136428,572,1450072,20282464
2024-11-20 04:55:13,1858332,48156,440,193604,13316,982056,364060,939068,312816,42988,51244,520908,348456,1251324,136432,572,1450072,20282584
2024-11-20 04:55:16,1858332,52040,440,193604,13316,977384,364060,934396,312816,42988,51244,520908,348600,1246560,135492,572,1450072,20282400
2024-11-20 04:55:18,1858332,47672,440,198748,13316,977256,368700,934268,312316,42988,56384,520908,348860,1245864,136212,572,1450072,20298848
2024-11-20 04:55:21,1858332,47276,440,198744,13316,977960,368648,934972,312264,42988,56384,520908,348860,1246612,136004,572,1450072,20298816
2024-11-20 04:55:24,1858332,48684,432,198740,13320,978568,367996,935580,311624,42988,56372,520908,348852,1246592,136064,572,1450072,20298784
2024-11-20 04:55:26,1858332,48604,432,198740,13320,978608,367996,935620,311624,42988,56372,520908,348852,1246620,136104,572,1450072,20298988
2024-11-20 04:55:28,1858332,48404,432,198740,13320,978816,367992,935828,311620,42988,56372,520908,348852,1246948,136064,572,1450072,20298940
2024-11-20 04:55:31,1858332,48484,432,198740,13320,978720,367992,935732,311620,42988,56372,520908,348852,1246808,136064,572,1450072,20298840
2024-11-20 04:55:33,1858332,48736,432,198740,13320,978884,367940,935896,311568,42988,56372,520908,348856,1246900,136076,572,1450072,20298864
2024-11-20 04:55:36,1858332,48292,432,198740,13320,979040,367928,936052,311556,42988,56372,520908,348892,1247200,135912,572,1450072,20298960
2024-11-20 04:55:38,1858332,47916,440,198772,13320,979544,367928,936556,311556,42988,56372,520908,348892,1247536,136064,572,1450072,20298868
2024-11-20 04:55:41,1858332,48032,440,198772,13320,979680,367968,936692,311556,42988,56412,520908,348892,1247560,135980,572,1450072,20298940
2024-11-20 04:55:44,1858332,47528,440,198880,13320,979644,368076,936656,311556,42988,56520,520908,348892,1247484,136068,572,1450072,20298732
2024-11-20 04:55:46,1858332,47248,440,198880,13320,979748,368076,936760,311556,42988,56520,520908,348892,1247820,136084,572,1450072,20298748
2024-11-20 04:55:49,1858332,46928,440,198880,13320,980072,368076,937084,311556,42988,56520,520908,348892,1248104,135884,572,1450072,20298864
2024-11-20 04:55:51,1858332,46876,440,198880,13320,980080,368076,937092,311556,42988,56520,520908,348892,1248204,136088,572,1450072,20298688
2024-11-20 04:55:54,1858332,46516,440,198880,13320,980604,368080,937616,311560,42988,56520,520908,348900,1248452,135884,572,1450072,20298780
2024-11-20 04:55:56,1858332,48512,424,198224,13312,980492,368072,937504,312340,42988,55732,520908,348928,1249408,136096,572,1450072,20298720
2024-11-20 04:55:59,1858332,48300,424,198264,13312,980836,368272,937848,312384,42988,55888,520908,348928,1249640,136208,572,1450072,20298728
2024-11-20 04:56:01,1858332,47472,424,198264,13312,981188,368272,938200,312384,42988,55888,520908,348928,1249876,136184,572,1450072,20298708
2024-11-20 04:56:04,1858332,47288,424,198264,13312,981416,368272,938428,312384,42988,55888,520908,348928,1250140,136184,572,1450072,20298908
2024-11-20 04:56:07,1858332,46496,424,198264,13312,981800,368272,938812,312384,42988,55888,520908,348928,1250504,136188,572,1450072,20298804
2024-11-20 04:56:09,1858332,39888,424,198368,13312,988712,368364,945724,312372,42988,55992,520908,348928,1257740,136240,572,1450072,20298736
2024-11-20 04:56:12,1858332,39804,424,198368,13312,988780,368364,945792,312372,42988,55992,520908,348928,1257620,136196,572,1450072,20298792
2024-11-20 04:56:14,1858332,42872,392,196912,13312,987400,369052,944396,314564,43004,54488,520908,348920,1258076,136228,572,1450072,20298752
2024-11-20 04:56:17,1858332,42708,392,196908,13316,988016,369052,945012,314564,43004,54488,520908,348924,1259052,136024,572,1450072,20298848
2024-11-20 04:56:20,1858332,39592,392,199508,13316,988868,372116,945864,315120,43004,56996,520908,348932,1260596,136272,572,1450072,20298740
2024-11-20 04:56:22,1858332,46996,392,199508,13316,981916,372200,938912,315116,43004,57084,520908,348932,1253332,136216,572,1450072,20298780
2024-11-20 04:56:24,1858332,43952,392,201868,13428,982172,374816,939168,315372,43004,59444,520908,349140,1253732,136416,572,1450072,20298844
2024-11-20 04:56:27,1858332,43676,392,201868,13428,982648,374816,939644,315372,43004,59444,520908,349140,1254368,136440,572,1450072,20298796
2024-11-20 04:56:30,1858332,43456,392,201868,13428,982428,374816,939424,315372,43004,59444,520908,349140,1254392,136416,572,1450072,20298812
2024-11-20 04:56:32,1858332,43116,392,201868,13428,982712,374816,939708,315372,43004,59444,520908,349140,1254548,136360,572,1450072,20298856
2024-11-20 04:56:35,1858332,42896,392,201868,13428,983180,374816,940176,315372,43004,59444,520908,349140,1255064,136416,572,1450072,20298712
2024-11-20 04:56:37,1858332,42788,392,201868,13428,983196,374816,940192,315372,43004,59444,520908,349140,1254752,136328,572,1450072,20298956
2024-11-20 04:56:40,1858332,42504,392,201868,13428,983936,374808,940924,315372,43012,59436,520908,349140,1255376,136420,572,1450072,20298960
2024-11-20 04:56:42,1858332,42176,392,201868,13428,983744,374808,940732,315372,43012,59436,520908,349140,1255628,136256,572,1450072,20298764
2024-11-20 04:56:45,1858332,41756,392,201868,13428,984140,374808,941128,315372,43012,59436,520908,349140,1255804,136420,572,1450072,20298868
2024-11-20 04:56:47,1858332,41516,392,201868,13432,984544,374812,941532,315376,43012,59436,520908,349168,1256216,136420,572,1450072,20298848
2024-11-20 04:56:50,1858332,41328,392,204724,13444,985352,376832,942264,314800,43088,62032,520908,349208,1256500,136932,572,1450072,20298692
2024-11-20 04:56:53,1858332,41280,392,204648,13444,985580,376920,942492,314780,43088,62140,520908,349208,1256872,136924,572,1450072,20298772
2024-11-20 04:56:55,1858332,41108,392,204648,13444,985812,376920,942724,314780,43088,62140,520908,349216,1256856,136944,572,1450072,20298832
2024-11-20 04:56:58,1858332,40864,392,204648,13444,985972,376912,942884,314772,43088,62140,520908,349364,1257084,136924,572,1450072,20298876
2024-11-20 04:57:00,1858332,40204,392,204704,13444,986492,376996,943404,314800,43088,62196,520908,349368,1257640,136796,572,1450072,20298872
2024-11-20 04:57:03,1858332,40048,392,204704,13444,986408,376996,943320,314800,43088,62196,520908,349368,1257420,137112,572,1450072,20298764
2024-11-20 04:57:05,1858332,39668,392,204704,13444,986744,376996,943656,314800,43088,62196,520908,349368,1257852,136980,572,1450072,20298828
2024-11-20 04:57:08,1858332,39932,392,204704,13444,986504,377004,943416,314808,43088,62196,520908,349376,1257908,136744,572,1450072,20298956
2024-11-20 04:57:10,1858332,39748,392,204704,13444,987192,377004,944104,314808,43088,62196,520908,349544,1258168,136956,572,1450072,20298884
2024-11-20 04:57:13,1858332,39368,392,204704,13444,987260,377004,944172,314808,43088,62196,520908,349544,1258452,136928,572,1450072,20298820
2024-11-20 04:57:15,1858332,40684,384,202712,13444,989100,375260,945992,315168,43108,60092,520908,349548,1260472,137116,572,1450072,20300232
2024-11-20 04:57:18,1858332,40716,384,202712,13444,989184,375276,946076,315100,43108,60176,520908,349548,1260564,137256,572,1450072,20300436
2024-11-20 04:57:21,1858332,40676,384,202712,13444,989344,375276,946236,315100,43108,60176,520908,349548,1260544,137300,572,1450072,20300400
2024-11-20 04:57:23,1858332,40620,384,202712,13444,989476,375276,946368,315100,43108,60176,520908,349548,1260664,137344,572,1450072,20300356
2024-11-20 04:57:26,1858332,39936,384,202712,13444,989744,375272,946636,315096,43108,60176,520908,349548,1260908,137300,572,1450072,20300372
2024-11-20 04:57:28,1858332,39796,384,202712,13444,989784,375272,946676,315096,43108,60176,520908,349548,1261308,137304,572,1450072,20300424
2024-11-20 04:57:31,1858332,39980,384,202712,13444,990264,375272,947156,315096,43108,60176,520908,349548,1261568,137252,572,1450072,20300348
2024-11-20 04:57:34,1858332,39644,384,202712,13444,990296,375272,947188,315096,43108,60176,520908,349552,1261780,137300,572,1450072,20300480
2024-11-20 04:57:36,1858332,39620,384,202712,13444,990528,375280,947420,315104,43108,60176,520908,349556,1261912,137364,572,1450072,20300472
2024-11-20 04:57:39,1858332,39296,384,202712,13444,990892,375280,947784,315104,43108,60176,520908,349556,1262296,137328,572,1450072,20300356
2024-11-20 04:57:42,1858332,39036,384,202712,13444,991912,375280,948804,315104,43108,60176,520908,349556,1263476,137304,572,1450072,20300308
2024-11-20 04:57:44,1858332,45456,384,202712,13444,984856,375160,941748,314984,43108,60176,520908,349560,1255876,137356,572,1450072,20300432
2024-11-20 04:57:47,1858332,45812,384,202712,13444,985256,375068,942148,314892,43108,60176,520908,349560,1256324,137304,572,1450072,20300256
2024-11-20 04:57:49,1858332,45612,384,202712,13444,985660,375068,942552,314892,43108,60176,520908,349560,1256616,137304,572,1450072,20300396
2024-11-20 04:57:52,1858332,45456,384,202712,13444,985672,375068,942564,314892,43108,60176,520908,349560,1256832,137252,572,1450072,20300240
2024-11-20 04:57:55,1858332,44924,384,202708,13448,985784,375068,942676,314892,43108,60176,520908,349560,1257060,137304,572,1450072,20300324
2024-11-20 04:57:57,1858332,45156,384,202712,13448,986156,375076,943048,314900,43108,60176,520908,349564,1257364,137308,572,1450072,20300360
2024-11-20 04:58:00,1858332,44712,384,202712,13448,986272,375076,943164,314900,43108,60176,520908,349564,1257436,137304,572,1450072,20300264
2024-11-20 04:58:02,1858332,44656,384,202712,13448,986248,375076,943140,314900,43108,60176,520908,349564,1257464,137124,572,1450072,20300444
2024-11-20 04:58:05,1858332,44048,384,202712,13448,986720,375076,943612,314900,43108,60176,520908,349568,1258024,137308,572,1450072,20300308
2024-11-20 04:58:07,1858332,45788,384,202712,13448,985572,374700,942464,314524,43108,60176,520908,349748,1256508,137176,572,1450072,20300336
2024-11-20 04:58:10,1858332,45600,384,202712,13448,985676,374700,942568,314524,43108,60176,520908,349748,1256712,137308,572,1450072,20300364
2024-11-20 04:58:12,1858332,45716,384,202712,13448,985916,374700,942808,314524,43108,60176,520908,349748,1256624,137308,572,1450072,20300520
2024-11-20 04:58:15,1858332,45268,384,202712,13448,986168,374700,943060,314524,43108,60176,520908,349748,1256912,137216,572,1450072,20300460
2024-11-20 04:58:18,1858332,45256,384,202712,13448,986148,374704,943040,314528,43108,60176,520908,349752,1257136,137124,572,1450072,20300224
2024-11-20 04:58:21,1858332,44700,384,202712,13448,986468,374704,943360,314528,43108,60176,520908,349752,1257504,137308,572,1450072,20300252
2024-11-20 04:58:23,1858332,44264,384,202712,13448,987200,374704,944092,314528,43108,60176,520908,349752,1258184,137316,572,1450072,20300436
2024-11-20 04:58:26,1858332,44464,384,202712,13448,987320,374704,944212,314528,43108,60176,520908,349752,1258224,137308,572,1450072,20300368
2024-11-20 04:58:28,1858332,43912,384,202712,13448,987464,374704,944356,314528,43108,60176,520908,349752,1258352,137352,572,1450072,20300348
2024-11-20 04:58:31,1858332,43856,384,202712,13448,987764,374708,944656,314532,43108,60176,520908,349756,1258764,137124,572,1450072,20300308
2024-11-20 04:58:33,1858332,43380,384,202712,13448,988156,374708,945048,314532,43108,60176,520908,349756,1259040,137308,572,1450072,20300328
2024-11-20 04:58:36,1858332,43528,384,202712,13448,987996,374708,944888,314532,43108,60176,520908,349756,1259044,137348,572,1450072,20300400
2024-11-20 04:58:39,1858332,43380,384,202712,13448,988432,374708,945324,314532,43108,60176,520908,349756,1259316,137492,572,1450072,20300304
2024-11-20 04:58:41,1858332,42744,384,202712,13448,988728,374708,945620,314532,43108,60176,520908,349756,1259372,137176,572,1450072,20300400
2024-11-20 04:58:44,1858332,43352,384,202712,13448,988752,374708,945644,314532,43108,60176,520908,349756,1259536,137312,572,1450072,20300352
2024-11-20 04:58:47,1858332,43196,384,202712,13448,988932,374708,945824,314532,43108,60176,520908,349756,1259796,137124,572,1450072,20300376
2024-11-20 04:58:49,1858332,42552,384,202712,13448,989116,374708,946008,314532,43108,60176,520908,349756,1259840,137304,572,1450072,20300284
2024-11-20 04:58:51,1858332,41876,384,202712,13448,989496,374708,946388,314532,43108,60176,520908,349756,1260372,137308,572,1450072,20300376
2024-11-20 04:58:54,1858332,41272,384,202712,13448,990280,374708,947172,314532,43108,60176,520908,349756,1261056,137308,572,1450072,20300280
2024-11-20 04:58:56,1858332,40340,384,202712,13448,991084,374712,947976,314536,43108,60176,520908,349776,1262028,137308,572,1450072,20300356
2024-11-20 04:58:59,1858332,48036,384,202712,13448,983552,374716,940444,314540,43108,60176,520908,349788,1254340,137352,572,1450072,20300324
2024-11-20 04:59:02,1858332,47540,384,202712,13448,983588,374716,940480,314540,43108,60176,520908,349788,1254456,137308,572,1450072,20300328
2024-11-20 04:59:04,1858332,47488,384,202868,13448,983848,374872,940740,314540,43108,60332,520908,349848,1254884,137352,572,1450072,20300136
2024-11-20 04:59:07,1858332,47188,384,202868,13448,984032,374872,940924,314540,43108,60332,520908,349848,1254932,137356,572,1450072,20300228
2024-11-20 04:59:10,1858332,47376,384,202868,13448,984380,374872,941272,314540,43108,60332,520908,349848,1255160,137332,572,1450072,20300376
2024-11-20 04:59:12,1858332,47148,384,202868,13448,984244,374872,941136,314540,43108,60332,520908,349848,1254936,137408,572,1450072,20300404
2024-11-20 04:59:15,1858332,46140,384,202868,13448,985100,374872,941992,314540,43108,60332,520908,349848,1255876,137332,572,1450072,20300360
2024-11-20 04:59:17,1858332,46188,384,202868,13448,985228,374872,942120,314540,43108,60332,520908,349848,1255884,137356,572,1450072,20300392
2024-11-20 04:59:19,1858332,45828,384,202868,13448,985592,374872,942484,314540,43108,60332,520908,349848,1256360,137332,572,1450072,20300512
2024-11-20 04:59:22,1858332,43376,384,202840,14000,987048,375352,943940,315020,43108,60332,520908,349864,1258200,138340,572,1450072,22220388
2024-11-20 04:59:25,1858332,35644,424,203636,14444,992492,376704,949384,315480,43108,61224,520908,349884,1263868,142496,572,1450072,24141584
2024-11-20 04:59:28,1858332,33576,356,197584,14444,1000284,371136,954964,318444,45320,52692,520908,349100,1271756,142692,572,1450072,24143088
2024-11-20 04:59:30,1858332,33228,348,195552,14436,1003908,368912,957724,319208,46184,49704,520908,349092,1275604,144708,568,1450072,24143916
2024-11-20 04:59:33,1858332,50888,412,185376,14368,983508,361272,940580,318220,42928,43052,520908,349016,1256920,133908,568,1450072,20300480
2024-11-20 04:59:35,1858332,49112,420,186980,14436,983764,362836,940792,318216,42972,44620,520908,349016,1257168,133768,568,1450072,20300340
2024-11-20 04:59:38,1858332,48396,420,186960,14532,984460,362852,941488,318224,42972,44628,520908,349016,1258168,133768,568,1450072,20300392
2024-11-20 04:59:40,1858332,53384,420,186988,14532,979648,362840,936676,318212,42972,44628,520908,349016,1253024,133252,568,1450072,20300376
2024-11-20 04:59:43,1858332,53356,420,186988,14540,980132,362812,937152,318192,42980,44620,520908,349016,1253368,133228,568,1450072,20300476
2024-11-20 04:59:46,1858332,53280,420,186988,14540,979924,362812,936944,318192,42980,44620,520908,349016,1253328,133204,568,1450072,20300520
2024-11-20 04:59:48,1858332,53628,420,186988,14540,979468,362804,936488,318184,42980,44620,520908,349016,1252992,133020,568,1450072,20300296
2024-11-20 04:59:51,1858332,52476,456,187612,14544,980240,363472,937248,318216,42992,45256,520908,349044,1253892,133084,568,1450072,20300236
2024-11-20 04:59:53,1858332,52184,456,187612,14544,980276,363476,937276,318216,43000,45260,520908,349044,1253732,133268,568,1450072,20300256
2024-11-20 04:59:56,1858332,44276,488,192568,14572,982824,368404,939780,318308,43044,50096,520908,349108,1256432,134548,572,1450072,22221612
2024-11-20 04:59:59,1858332,35044,528,193656,14584,989304,369624,946188,318428,43116,51196,520908,349252,1262856,140024,572,1450072,24142108
2024-11-20 05:00:02,1858332,33492,528,193328,14572,998536,368804,954996,318444,43540,50360,520908,349156,1272072,143484,572,1450072,24142908
2024-11-20 05:00:04,1858332,45384,520,190448,14460,986248,361988,938496,318640,47752,43348,520908,348648,1255352,134004,576,1450072,20300400
2024-11-20 05:00:07,1858332,40636,972,195324,14520,986116,367456,938344,318828,47772,48628,520908,348780,1255440,134248,572,1450072,20300308
2024-11-20 05:00:09,1858332,39388,1472,195416,14520,986700,367984,938856,318836,47844,49148,520908,348784,1255800,134300,572,1450072,20292124
2024-11-20 05:00:11,1858332,39060,1472,195412,14524,986636,368044,938780,318824,47856,49220,520908,348828,1255740,134248,572,1450072,20300444
2024-11-20 05:00:14,1858332,40540,1484,194692,14500,986972,366528,939116,318096,47856,48432,520908,348828,1255664,134248,572,1450072,20300492
2024-11-20 05:00:16,1858332,42304,1484,194076,14496,987908,365740,940048,317852,47860,47888,520908,348800,1256184,134272,572,1450072,20300340
2024-11-20 05:00:18,1858332,41848,1484,194076,14496,988072,365740,940212,317852,47860,47888,520908,348800,1256204,134248,572,1450072,20300460
2024-11-20 05:00:20,1858332,41768,1484,194076,14496,988072,365740,940212,317852,47860,47888,520908,348800,1256440,134064,572,1450072,20300400
2024-11-20 05:00:23,1858332,41384,1484,194076,14496,988272,365740,940412,317852,47860,47888,520908,348800,1256460,134248,572,1450072,20300440
2024-11-20 05:00:25,1858332,41364,1484,194076,14496,988512,365740,940652,317852,47860,47888,520908,348800,1256756,134248,572,1450072,20300496
2024-11-20 05:00:27,1858332,41304,1484,194076,14496,988492,365740,940632,317852,47860,47888,520908,348800,1256728,134232,572,1450072,20300488
2024-11-20 05:00:29,1858332,41404,1484,194076,14496,988696,365740,940836,317852,47860,47888,520908,348800,1256908,134248,572,1450072,20300472
2024-11-20 05:00:31,1858332,41344,1484,194076,14496,988464,365740,940604,317852,47860,47888,520908,348800,1256760,134248,572,1450072,20300372
2024-11-20 05:00:34,1858332,41108,1484,194076,14496,989056,365740,941196,317852,47860,47888,520908,348804,1257424,134248,572,1450072,20300408
2024-11-20 05:00:36,1858332,40612,1484,194076,14496,989236,365740,941376,317852,47860,47888,520908,348808,1257428,134248,572,1450072,20300432
2024-11-20 05:00:38,1858332,42824,1484,195140,14500,990700,365280,942812,316356,47888,48924,520908,348668,1257176,134300,572,1450072,20300316
2024-11-20 05:00:40,1858332,42500,1484,195140,14500,990996,365280,943108,316356,47888,48924,520908,348668,1257832,134300,572,1450072,20300348
2024-11-20 05:00:43,1858332,42228,1484,195140,14500,991288,365280,943400,316356,47888,48924,520908,348668,1258020,134300,572,1450072,20300344
2024-11-20 05:00:45,1858332,42356,1484,195140,14500,991300,365280,943412,316356,47888,48924,520908,348668,1257928,134300,572,1450072,20300316
2024-11-20 05:00:47,1858332,42324,1484,195140,14500,991396,365280,943508,316356,47888,48924,520908,348668,1258072,134312,572,1450072,20300412
2024-11-20 05:00:49,1858332,42084,1484,195140,14500,991564,365280,943676,316356,47888,48924,520908,348668,1258412,134300,572,1450072,20300412
2024-11-20 05:00:52,1858332,42084,1484,195140,14500,991868,365280,943980,316356,47888,48924,520908,348668,1258596,134300,572,1450072,20300336
2024-11-20 05:00:54,1858332,46188,1484,196812,14500,985712,366960,937824,316364,47888,50596,520908,348676,1252456,133552,572,1450072,20300420
2024-11-20 05:00:56,1858332,46136,1484,196812,14500,985792,366968,937904,316372,47888,50596,520908,348684,1252472,133600,572,1450072,20300236
2024-11-20 05:00:58,1858332,45860,1484,196812,14500,986092,366968,938204,316372,47888,50596,520908,348684,1252792,133556,572,1450072,20300156
2024-11-20 05:01:00,1858332,45892,1484,196812,14500,986092,366968,938204,316372,47888,50596,520908,348684,1252792,133556,572,1450072,20300280
2024-11-20 05:01:02,1858332,46076,1484,196812,14500,985992,366968,938104,316372,47888,50596,520908,348684,1252732,133556,572,1450072,20300380
2024-11-20 05:01:05,1858332,45752,1484,196812,14500,986004,366968,938116,316372,47888,50596,520908,348684,1252804,133372,572,1450072,20300324
2024-11-20 05:01:07,1858332,45408,1484,196812,14496,986364,366976,938476,316380,47888,50596,520908,348696,1253100,133608,572,1450072,20300476
2024-11-20 05:01:09,1858332,45044,1484,196812,14496,986892,366976,939004,316380,47888,50596,520908,348696,1253612,133556,572,1450072,20300464
2024-11-20 05:01:11,1858332,45136,1484,196812,14496,986900,366976,939012,316380,47888,50596,520908,348696,1253616,133556,572,1450072,20300456
2024-11-20 05:01:13,1858332,44772,1484,196812,14496,987152,366976,939264,316380,47888,50596,520908,348696,1253872,133556,572,1450072,20300460
2024-11-20 05:01:16,1858332,44592,1484,196812,14496,987176,366976,939288,316380,47888,50596,520908,348696,1253904,133556,572,1450072,20300392
2024-11-20 05:01:18,1858332,44252,1484,196812,14496,987440,366976,939552,316380,47888,50596,520908,348696,1254160,133556,572,1450072,20300340
2024-11-20 05:01:20,1858332,44160,1484,196812,14496,987348,366936,939460,316340,47888,50596,520908,348696,1254096,133608,572,1450072,20300328
2024-11-20 05:01:22,1858332,44180,1484,196812,14496,987512,366936,939624,316340,47888,50596,520908,348696,1254224,133556,572,1450072,20300444
2024-11-20 05:01:24,1858332,43992,1484,196812,14496,987856,366936,939968,316340,47888,50596,520908,348696,1254552,133556,572,1450072,20300416
2024-11-20 05:01:26,1858332,43864,1484,196812,14496,987876,366936,939988,316340,47888,50596,520908,348696,1254552,133556,572,1450072,20300536
2024-11-20 05:01:29,1858332,43536,1484,196812,14496,988020,366936,940132,316340,47888,50596,520908,348696,1254756,133556,572,1450072,20300412
2024-11-20 05:01:31,1858332,43296,1484,196812,14496,988176,366936,940288,316340,47888,50596,520908,348696,1254844,133556,572,1450072,20300568
2024-11-20 05:01:33,1858332,43036,1484,196812,14496,988228,366936,940340,316340,47888,50596,520908,348696,1254832,133516,572,1450072,20300536
2024-11-20 05:01:35,1858332,42620,1484,196812,14496,988668,366936,940780,316340,47888,50596,520908,348696,1255488,133556,572,1450072,20300488
2024-11-20 05:01:38,1858332,42492,1484,196812,14496,989184,366936,941296,316340,47888,50596,520908,348696,1255948,133556,572,1450072,20300592
2024-11-20 05:01:40,1858332,41756,1484,196812,14496,989980,366940,942092,316344,47888,50596,520908,348700,1256636,133556,572,1450072,20300580
2024-11-20 05:01:42,1858332,41496,1484,196812,14496,990040,366940,942152,316344,47888,50596,520908,348700,1256756,133556,572,1450072,20300420
2024-11-20 05:01:44,1858332,41940,1484,196812,14496,990280,366940,942392,316344,47888,50596,520908,348700,1257204,133556,572,1450072,20300344
2024-11-20 05:01:46,1858332,41720,1484,196812,14496,990360,366940,942472,316344,47888,50596,520908,348700,1257044,133556,572,1450072,20300468
2024-11-20 05:01:49,1858332,41336,1484,196812,14496,990880,366944,942992,316348,47888,50596,520908,348704,1257564,133556,572,1450072,20300356
2024-11-20 05:01:51,1858332,41176,1484,196812,14496,990764,366944,942876,316348,47888,50596,520908,348704,1257632,133480,572,1450072,20300380
2024-11-20 05:01:53,1858332,40788,1484,196812,14496,990936,366944,943048,316348,47888,50596,520908,348704,1257428,133556,572,1450072,20300524
2024-11-20 05:01:55,1858332,40788,1484,196812,14496,991156,366944,943268,316348,47888,50596,520908,348724,1257844,133556,572,1450072,20300476
2024-11-20 05:01:57,1858332,40932,1484,196812,14496,990984,366944,943096,316348,47888,50596,520908,348724,1257888,133560,572,1450072,20300528
2024-11-20 05:02:00,1858332,40300,1484,196812,14496,991352,366944,943464,316348,47888,50596,520908,348724,1258072,133560,572,1450072,20300560
2024-11-20 05:02:02,1858332,40308,1484,196812,14496,991356,366944,943468,316348,47888,50596,520908,348724,1257956,133376,572,1450072,20300436
2024-11-20 05:02:04,1858332,40076,1484,196812,14496,991516,366944,943628,316348,47888,50596,520908,348724,1258268,133376,572,1450072,20300384
2024-11-20 05:02:06,1858332,39388,1484,196812,14496,991948,366944,944060,316348,47888,50596,520908,348852,1258620,133560,572,1450072,20300288
2024-11-20 05:02:08,1858332,39200,1484,196864,14496,992260,366964,944372,316368,47888,50596,520908,348852,1259064,133564,572,1450072,20300404
2024-11-20 05:02:11,1858332,45508,1484,196864,14496,985892,366948,938004,316352,47888,50596,520908,348856,1252584,133564,572,1450072,20300412
2024-11-20 05:02:13,1858332,45508,1484,196864,14496,986052,367000,938164,316352,47888,50648,520908,348856,1252688,133424,572,1450072,20300344
2024-11-20 05:02:15,1858332,45200,1484,196864,14496,986060,367000,938172,316352,47888,50648,520908,348856,1252772,133564,572,1450072,20300424
2024-11-20 05:02:17,1858332,45124,1484,196864,14496,986088,367000,938200,316352,47888,50648,520908,348856,1252780,133564,572,1450072,20300480
2024-11-20 05:02:20,1858332,44836,1516,196832,14496,986336,367000,938448,316352,47888,50648,520908,348856,1253220,133380,572,1450072,20300440
2024-11-20 05:02:22,1858332,44860,1516,196876,14496,986488,367040,938596,316352,47892,50688,520908,348856,1253144,133580,572,1450072,20300400
2024-11-20 05:02:24,1858332,44984,1516,196876,14496,986496,367040,938604,316352,47892,50688,520908,348856,1253176,133580,572,1450072,20300472
2024-11-20 05:02:26,1858332,44364,1524,196876,14496,986868,367040,938976,316352,47892,50688,520908,348856,1253716,133580,572,1450072,20300476
2024-11-20 05:02:28,1858332,44336,1524,196876,14496,986976,367048,939084,316352,47892,50696,520908,348856,1253700,133580,572,1450072,20300568
2024-11-20 05:02:31,1858332,44100,1524,196876,14496,987244,367052,939352,316356,47892,50696,520908,348860,1253908,133580,572,1450072,20300468
2024-11-20 05:02:33,1858332,44068,1524,196876,14496,987364,367052,939472,316356,47892,50696,520908,348860,1254120,133604,572,1450072,20300372
2024-11-20 05:02:35,1858332,44140,1524,196876,14496,987728,367068,939836,316372,47892,50696,520908,348896,1254368,133396,572,1450072,20300248
2024-11-20 05:02:37,1858332,43512,1524,196876,14496,988100,367068,940208,316372,47892,50696,520908,348896,1254812,133580,572,1450072,20300512
2024-11-20 05:02:40,1858332,42700,1564,197844,14496,988056,367972,940064,316368,47992,51604,520908,348896,1254660,133600,572,1450072,20300456
2024-11-20 05:02:42,1858332,41996,1564,197844,14496,988400,367972,940408,316368,47992,51604,520908,348896,1255076,133580,572,1450072,20300508
2024-11-20 05:02:45,1858332,42292,1564,197844,14496,988936,367972,940944,316368,47992,51604,520908,348896,1255612,133580,572,1450072,20300452
2024-11-20 05:02:48,1858332,42040,1564,197844,14496,989180,367972,941188,316368,47992,51604,520908,348896,1255884,133592,572,1450072,20300396
2024-11-20 05:02:50,1858332,41620,1564,197844,14496,989704,367972,941712,316368,47992,51604,520908,348896,1256248,133668,572,1450072,20300432
2024-11-20 05:02:53,1858332,41948,1564,197844,14496,989684,367972,941692,316368,47992,51604,520908,348896,1256324,133396,572,1450072,20300352
2024-11-20 05:02:55,1858332,41420,1564,197844,14496,989932,367972,941940,316368,47992,51604,520908,348896,1256672,133628,572,1450072,20300348
2024-11-20 05:02:58,1858332,41232,1564,197844,14496,990084,367972,942092,316368,47992,51604,520908,348896,1256848,133580,572,1450072,20300364
2024-11-20 05:03:00,1858332,41216,1564,197844,14496,990660,367976,942668,316372,47992,51604,520908,348900,1257460,133632,572,1450072,20300472
2024-11-20 05:03:03,1858332,40832,1564,197844,14496,990792,367976,942800,316372,47992,51604,520908,348900,1257640,133580,572,1450072,20300404
2024-11-20 05:03:05,1858332,40516,1564,197844,14496,990816,367980,942824,316376,47992,51604,520908,348904,1257460,133580,572,1450072,20300380
2024-11-20 05:03:08,1858332,40216,1564,197844,14496,991364,367984,943372,316380,47992,51604,520908,348908,1257952,133536,572,1450072,20300324
2024-11-20 05:03:11,1858332,40256,1564,197844,14496,991124,367984,943132,316380,47992,51604,520908,348908,1257772,133396,572,1450072,20300424
2024-11-20 05:03:13,1858332,40528,1564,197844,14496,991188,367984,943196,316380,47992,51604,520908,348908,1257824,133524,572,1450072,20300440
2024-11-20 05:03:16,1858332,40200,1564,197844,14496,991468,367984,943476,316380,47992,51604,520908,348908,1258384,133580,572,1450072,20300492
2024-11-20 05:03:18,1858332,39632,1564,197844,14496,991816,367984,943824,316380,47992,51604,520908,348908,1258472,133580,572,1450072,20300356
2024-11-20 05:03:21,1858332,39764,1564,197844,14496,991916,367984,943924,316380,47992,51604,520908,348908,1258628,133396,572,1450072,20300328
2024-11-20 05:03:23,1858332,39652,1564,197844,14496,992248,367984,944256,316380,47992,51604,520908,348908,1258756,133616,572,1450072,20300412
2024-11-20 05:03:26,1858332,39488,1564,197844,14496,992168,367984,944176,316380,47992,51604,520908,348908,1258740,133580,572,1450072,20300300
2024-11-20 05:03:28,1858332,38076,1564,197880,14504,993392,368024,945400,316376,47992,51648,520908,348956,1260080,133604,572,1450072,20300420
2024-11-20 05:03:31,1858332,44772,1572,197888,14504,986792,367852,938800,316196,47992,51656,520908,348992,1253356,133612,572,1450072,20300424
2024-11-20 05:03:33,1858332,44676,1572,197888,14504,987408,367852,939416,316196,47992,51656,520908,348992,1253820,133580,572,1450072,20300300
2024-11-20 05:03:36,1858332,44040,1580,197888,14504,987448,367860,939456,316196,47992,51664,520908,348992,1253968,133428,572,1450072,20300320
2024-11-20 05:03:38,1858332,44340,1580,197880,14512,987496,367860,939504,316196,47992,51664,520908,348992,1254040,133612,572,1450072,20300344
2024-11-20 05:03:40,1858332,43904,1580,197888,14512,987600,367868,939608,316204,47992,51664,520908,348992,1254172,133480,572,1450072,20300524
2024-11-20 05:03:43,1858332,43860,1580,197888,14512,987852,367868,939860,316204,47992,51664,520908,348992,1254084,133436,572,1450072,20300480
2024-11-20 05:03:45,1858332,43828,1580,197888,14512,988148,367868,940156,316204,47992,51664,520908,348992,1254608,133644,572,1450072,20300460
2024-11-20 05:03:48,1858332,43696,1580,197888,14512,987820,367868,939828,316204,47992,51664,520908,348992,1254788,133436,572,1450072,20300420
2024-11-20 05:03:50,1858332,42912,1580,197888,14512,988616,367868,940624,316204,47992,51664,520908,348992,1255036,133560,572,1450072,20300264
2024-11-20 05:03:53,1858332,42596,1580,197888,14512,988756,367868,940764,316204,47992,51664,520908,348992,1255180,133436,572,1450072,20300336
2024-11-20 05:03:55,1858332,42124,1580,197888,14512,988984,367872,940992,316208,47992,51664,520908,348996,1255456,133672,572,1450072,20300356
2024-11-20 05:03:58,1858332,42208,1580,197888,14512,989120,367872,941128,316208,47992,51664,520908,348996,1255672,133620,572,1450072,20300420
2024-11-20 05:04:00,1858332,41724,1580,197888,14512,989680,367872,941688,316208,47992,51664,520908,348996,1256500,133544,572,1450072,20300420
2024-11-20 05:04:03,1858332,41940,1580,197888,14512,989984,367872,941992,316208,47992,51664,520908,348996,1256340,133620,572,1450072,20300392
2024-11-20 05:04:05,1858332,41340,1580,197888,14512,990176,367872,942184,316208,47992,51664,520908,348996,1256688,133672,572,1450072,20300512
2024-11-20 05:04:08,1858332,40856,1580,197888,14512,990876,367872,942884,316208,47992,51664,520908,348996,1257436,133620,572,1450072,20300404
2024-11-20 05:04:10,1858332,40100,1580,197888,14512,991368,367872,943376,316208,47992,51664,520908,348996,1257828,133620,572,1450072,20300344
2024-11-20 05:04:13,1858332,40004,1580,197888,14512,991660,367872,943668,316208,47992,51664,520908,348996,1258064,133436,572,1450072,20300488
2024-11-20 05:04:15,1858332,39564,1580,197888,14512,992104,367868,944112,316204,47992,51664,520908,348996,1258524,133692,572,1450072,20300248
2024-11-20 05:04:18,1858332,39156,1580,197888,14512,992520,367868,944528,316204,47992,51664,520908,348996,1259136,133620,572,1450072,20300236
2024-11-20 05:04:21,1858332,38368,1580,197888,14512,993144,367868,945152,316204,47992,51664,520908,348996,1259712,133436,572,1450072,20300436
2024-11-20 05:04:23,1858332,37604,1580,197888,14552,993828,367924,945836,316260,47992,51664,520908,349012,1260308,133632,572,1450072,20300424
2024-11-20 05:04:26,1858332,44072,1580,197888,14552,986808,367924,938816,316260,47992,51664,520908,349012,1253252,133628,572,1450072,20300384
2024-11-20 05:04:28,1858332,44584,1580,197888,14552,986968,367924,938976,316260,47992,51664,520908,349012,1253360,133680,572,1450072,20300472
2024-11-20 05:04:31,1858332,44488,1580,197888,14552,986852,367924,938860,316260,47992,51664,520908,349012,1253400,133628,572,1450072,20300408
2024-11-20 05:04:33,1858332,44480,1580,197888,14552,987056,367924,939064,316260,47992,51664,520908,349012,1253692,133672,572,1450072,20300260
2024-11-20 05:04:35,1858332,44448,1580,197888,14552,987276,367924,939284,316260,47992,51664,520908,349012,1253896,133628,572,1450072,20300280
2024-11-20 05:04:38,1858332,44080,1580,197888,14552,987444,367932,939452,316268,47992,51664,520908,349020,1253908,133448,572,1450072,20300428
2024-11-20 05:04:40,1858332,43672,1580,197888,14552,987972,367936,939980,316272,47992,51664,520908,349024,1254632,133632,572,1450072,20300456
2024-11-20 05:04:43,1858332,42984,1580,197888,14552,988260,367936,940268,316272,47992,51664,520908,349024,1254748,133448,572,1450072,20300388
2024-11-20 05:04:45,1858332,42788,1580,197888,14552,988580,367936,940588,316272,47992,51664,520908,349024,1255244,133632,572,1450072,20300236
2024-11-20 05:04:48,1858332,42552,1580,197888,14552,988988,367936,940996,316272,47992,51664,520908,349024,1255496,133632,572,1450072,20300344
2024-11-20 05:04:51,1858332,42072,1580,197888,14552,989572,367936,941580,316272,47992,51664,520908,349024,1256052,133632,572,1450072,20300308
2024-11-20 05:04:53,1858332,41640,1580,197888,14552,989644,367936,941652,316272,47992,51664,520908,349024,1256140,133652,572,1450072,20300460
2024-11-20 05:04:56,1858332,41344,1580,197888,14552,990276,367936,942284,316272,47992,51664,520908,349028,1256912,133816,572,1450072,20300400
2024-11-20 05:04:58,1858332,41056,1580,197888,14552,990420,367944,942428,316280,47992,51664,520908,349032,1257040,133448,572,1450072,20300416
2024-11-20 05:05:01,1858332,40872,1580,197888,14552,990488,367944,942496,316280,47992,51664,520908,349032,1257044,133632,572,1450072,20300360
2024-11-20 05:05:03,1858332,40700,1580,197888,14552,990868,367944,942876,316280,47992,51664,520908,349032,1257344,133656,572,1450072,20300288
2024-11-20 05:05:05,1858332,40276,1580,197888,14552,991140,367944,943148,316280,47992,51664,520908,349032,1257528,133448,572,1450072,20300348
2024-11-20 05:05:08,1858332,39880,1580,197888,14548,991548,367948,943556,316284,47992,51664,520908,349040,1258264,133632,572,1450072,20300388
2024-11-20 05:05:11,1858332,39720,1580,197888,14548,991732,367952,943740,316288,47992,51664,520908,349044,1258076,133448,572,1450072,20300368
2024-11-20 05:05:13,1858332,39524,1580,197888,14548,991916,367952,943924,316288,47992,51664,520908,349044,1258604,133504,572,1450072,20300252
2024-11-20 05:05:16,1858332,38996,1580,197888,14548,992564,367952,944572,316288,47992,51664,520908,349044,1259312,133632,572,1450072,20300496
2024-11-20 05:05:18,1858332,38816,1580,197888,14548,992736,367952,944744,316288,47992,51664,520908,349044,1259484,133632,572,1450072,20308640
2024-11-20 05:05:21,1858332,38480,1580,197888,14548,992952,367952,944960,316288,47992,51664,520908,349044,1259632,133816,572,1450072,20308484
2024-11-20 05:05:23,1858332,38548,1580,197888,14548,992948,367952,944956,316288,47992,51664,520908,349044,1259408,133632,572,1450072,20308672
2024-11-20 05:05:26,1858332,38676,1580,197888,14548,992988,367952,944996,316288,47992,51664,520908,349044,1259680,133544,572,1450072,20308548
2024-11-20 05:05:29,1858332,37920,1580,197888,14548,993656,367952,945664,316288,47992,51664,520908,349044,1260364,133632,572,1450072,20308540
2024-11-20 05:05:31,1858332,45160,1580,197888,14548,986456,367956,938464,316292,47992,51664,520908,349048,1253132,133472,572,1450072,20308700
2024-11-20 05:05:33,1858332,44732,1580,197888,14548,986920,367956,938928,316292,47992,51664,520908,349048,1253400,133632,572,1450072,20308628
2024-11-20 05:05:36,1858332,44648,1580,197888,14548,987080,367956,939088,316292,47992,51664,520908,349048,1253760,133656,572,1450072,20308568
2024-11-20 05:05:39,1858332,44892,1580,197888,14548,986948,367956,938956,316292,47992,51664,520908,349048,1253732,133632,572,1450072,20308604
2024-11-20 05:05:41,1858332,44596,1580,197888,14548,987332,367956,939340,316292,47992,51664,520908,349048,1253868,133684,572,1450072,20308648
2024-11-20 05:05:44,1858332,44276,1580,197888,14548,987364,367956,939372,316292,47992,51664,520908,349048,1254036,133632,572,1450072,20308472
2024-11-20 05:05:46,1858332,43840,1580,197888,14548,987552,367956,939560,316292,47992,51664,520908,349048,1254100,133636,572,1450072,20308440
2024-11-20 05:05:49,1858332,43932,1580,197888,14548,988336,367956,940344,316292,47992,51664,520908,349048,1254788,133632,572,1450072,20308500
2024-11-20 05:05:51,1858332,43376,1580,197888,14548,988116,367956,940124,316292,47992,51664,520908,349048,1255112,133660,572,1450072,20308544
2024-11-20 05:05:54,1858332,43048,1580,197888,14548,988512,367956,940520,316292,47992,51664,520908,349048,1255308,133448,572,1450072,20308540
2024-11-20 05:05:57,1858332,42928,1580,197888,14548,988984,367956,940992,316292,47992,51664,520908,349060,1255536,133632,572,1450072,20308544
2024-11-20 05:05:59,1858332,42204,1580,197888,14548,989304,367956,941312,316292,47992,51664,520908,349060,1255808,133656,572,1450072,20308596
2024-11-20 05:06:02,1858332,41740,1580,197888,14548,989880,367956,941888,316292,47992,51664,520908,349060,1256568,133632,572,1450072,20308556
2024-11-20 05:06:04,1858332,41712,1580,197888,14548,989756,367956,941764,316292,47992,51664,520908,349060,1256408,133676,572,1450072,20308372
2024-11-20 05:06:07,1858332,41660,1580,197888,14548,990000,367956,942008,316292,47992,51664,520908,349060,1256500,133576,572,1450072,20308604
2024-11-20 05:06:10,1858332,41408,1580,197888,14548,990012,367956,942020,316292,47992,51664,520908,349060,1256660,133632,572,1450072,20308540
2024-11-20 05:06:12,1858332,41080,1580,197888,14548,990080,367956,942088,316292,47992,51664,520908,349060,1256688,133572,572,1450072,20308568
2024-11-20 05:06:15,1858332,41072,1580,198072,14548,990288,368204,942296,316292,47992,51912,520908,349060,1256952,133448,572,1450072,20308608
2024-11-20 05:06:17,1858332,40384,1580,198152,14548,990828,368220,942836,316292,47992,51928,520908,349060,1257508,133648,572,1450072,20308464
2024-11-20 05:06:20,1858332,39956,1580,198152,14548,991068,368220,943076,316292,47992,51928,520908,349060,1257748,133684,572,1450072,20308616
2024-11-20 05:06:23,1858332,39952,1580,198152,14548,991240,368220,943248,316292,47992,51928,520908,349060,1257740,133832,572,1450072,20308588
2024-11-20 05:06:25,1858332,39740,1580,198152,14548,991264,368220,943272,316292,47992,51928,520908,349060,1257828,133672,572,1450072,20308484
2024-11-20 05:06:28,1858332,39512,1580,198152,14548,991276,368220,943284,316292,47992,51928,520908,349060,1257860,133648,572,1450072,20308612
2024-11-20 05:06:30,1858332,38752,1580,198152,14548,991668,368220,943676,316292,47992,51928,520908,349060,1258232,133648,572,1450072,20308556
2024-11-20 05:06:32,1858332,38544,1580,198152,14548,991820,368220,943828,316292,47992,51928,520908,349060,1258388,133648,572,1450072,20308720
2024-11-20 05:06:35,1858332,38612,1580,198152,14548,992240,368220,944248,316292,47992,51928,520908,349060,1258856,133672,572,1450072,20308580
2024-11-20 05:06:37,1858332,45632,1684,203360,14564,988484,370180,940012,313460,48472,56720,520908,349092,1251800,134060,572,1450072,20170412
2024-11-20 05:06:39,1858332,45728,1684,203360,14564,988728,370220,940256,313460,48472,56760,520908,349092,1251920,134060,572,1450072,20170308
2024-11-20 05:06:41,1858332,45336,1684,203360,14564,988844,370220,940372,313460,48472,56760,520908,349092,1251940,134060,572,1450072,20170320
2024-11-20 05:06:43,1858332,44788,1684,203360,14564,989028,370216,940556,313456,48472,56760,520908,349128,1252180,134060,572,1450072,20170404
2024-11-20 05:06:46,1858332,50324,1684,203360,14564,982980,370216,934508,313456,48472,56760,520908,349128,1246316,134060,572,1450072,20170388
2024-11-20 05:06:48,1858332,49960,1684,203360,14564,983428,370216,934956,313456,48472,56760,520908,349128,1246504,134060,572,1450072,20170392
2024-11-20 05:06:50,1858332,49960,1684,203360,14564,983448,370216,934976,313456,48472,56760,520908,349128,1246596,134060,572,1450072,20170296
2024-11-20 05:06:52,1858332,49640,1684,203360,14564,983684,370216,935212,313456,48472,56760,520908,349128,1246952,134056,572,1450072,20170412
2024-11-20 05:06:54,1858332,49884,1684,203360,14564,983716,370216,935244,313456,48472,56760,520908,349128,1246752,134060,572,1450072,20170324
2024-11-20 05:06:56,1858332,49452,1684,203360,14564,983796,370216,935324,313456,48472,56760,520908,349128,1246940,134060,572,1450072,20170424
2024-11-20 05:06:58,1858332,49292,1684,203360,14564,984084,370216,935612,313456,48472,56760,520908,349128,1247260,134060,572,1450072,20170404
