Timestamp,MemTotal,MemFree,Buffers,Cached,SwapCached,Active,Inactive,Active(anon),Inactive(anon),Active(file),Inactive(file),SwapTotal,SwapFree,AnonPages,Mapped,Shmem,CommitLimit,Committed_AS
2024-11-20 05:23:38,1858332,1050772,872,323156,16276,86072,258616,46604,73868,39468,184748,520908,357688,119188,142248,572,1450072,22197612
2024-11-20 05:23:38,1858332,1050772,872,323156,16276,86072,258616,46604,73868,39468,184748,520908,357688,119188,142248,572,1450072,22197612
2024-11-20 05:23:38,1858332,1050772,872,323156,16276,86072,258616,46604,73868,39468,184748,520908,357688,119188,142248,572,1450072,22197612
2024-11-20 05:23:38,1858332,1050772,872,323156,16276,86072,258616,46604,73868,39468,184748,520908,357688,119188,142248,572,1450072,22197612
2024-11-20 05:23:38,1858332,1050772,872,323156,16276,86072,258616,46604,73868,39468,184748,520908,357688,119188,142248,572,1450072,22197612
2024-11-20 05:23:39,1858332,1047992,872,323292,16276,87988,258748,48520,73864,39468,184884,520908,357688,120936,142300,572,1450072,22197608
2024-11-20 05:23:39,1858332,1047992,872,323292,16276,87988,258748,48520,73864,39468,184884,520908,357688,120936,142300,572,1450072,22197608
2024-11-20 05:23:39,1858332,1047992,872,323292,16276,87988,258748,48520,73864,39468,184884,520908,357688,120936,142300,572,1450072,22197608
2024-11-20 05:23:39,1858332,1047992,872,323292,16276,87988,258748,48520,73864,39468,184884,520908,357688,120936,142300,572,1450072,22197608
2024-11-20 05:23:39,1858332,1047992,872,323292,16276,87988,258748,48520,73864,39468,184884,520908,357688,120936,142300,572,1450072,22197608
2024-11-20 05:23:39,1858332,1047992,872,323292,16276,87988,258748,48520,73864,39468,184884,520908,357688,120936,142300,572,1450072,22197608
2024-11-20 05:23:41,1858332,971096,1064,360344,16280,135884,286244,88340,72264,47544,213980,520908,357696,159252,151428,572,1450072,22397376
2024-11-20 05:23:43,1858332,933416,1064,360344,16280,173912,286124,126368,72112,47544,214012,520908,357696,197504,151432,572,1450072,22435340
2024-11-20 05:23:45,1858332,51596,1064,679556,16280,921664,418436,687252,72108,234412,346328,520908,357696,757876,151548,572,1450072,23205444
2024-11-20 05:23:47,1858332,33236,112,233056,15420,986892,369904,920708,303384,66184,66520,520908,355548,1222532,145688,572,1450072,24120820
2024-11-20 05:23:49,1858332,45216,180,191332,15416,996204,350340,953600,301272,42604,49068,520908,355816,1253348,137684,568,1450072,22205864
2024-11-20 05:23:51,1858332,37264,332,197984,15416,993308,369912,948860,316316,44448,53596,520908,355936,1263944,144024,568,1450072,24127792
2024-11-20 05:23:54,1858332,34676,500,185920,15204,996064,360416,952592,317600,43472,42816,520908,355580,1257948,142316,564,1450072,22208196
2024-11-20 05:23:56,1858332,39108,520,195328,15200,983900,369428,940020,317372,43880,52056,520908,355604,1255860,138180,564,1450072,20286092
2024-11-20 05:23:58,1858332,39088,520,195372,15200,984372,369532,940460,317356,43912,52176,520908,355604,1256100,138144,564,1450072,20286168
2024-11-20 05:24:00,1858332,45184,448,193092,15212,997400,361048,945948,318864,51452,42184,520908,355112,1263392,145188,560,1450072,22207256
2024-11-20 05:24:03,1858332,44624,448,193172,15212,997952,361204,946500,318840,51452,42364,520908,355116,1263832,145020,560,1450072,22207380
2024-11-20 05:24:05,1858332,43140,456,194332,15212,997776,362176,946324,318648,51452,43528,520908,355116,1263468,145344,560,1450072,22207232
2024-11-20 05:24:07,1858332,45108,456,195468,15212,995672,362464,944208,317836,51464,44628,520908,355132,1260608,144516,560,1450072,22207276
2024-11-20 05:24:10,1858332,45800,456,195468,15212,996224,362476,944760,317816,51464,44660,520908,355132,1261224,144600,560,1450072,22207084
2024-11-20 05:24:12,1858332,43928,456,197820,15212,996556,364356,945092,317344,51464,47012,520908,355132,1261108,144756,560,1450072,22207140
2024-11-20 05:24:15,1858332,43464,456,197816,15216,996960,364300,945496,317288,51464,47012,520908,355132,1261340,144576,560,1450072,22207272
2024-11-20 05:24:17,1858332,37044,464,199476,15372,1001276,365960,949636,317400,51640,48560,520908,355388,1265692,147016,560,1450072,24128356
2024-11-20 05:24:20,1858332,41540,464,196900,15376,998496,365468,948424,317968,50072,47500,520908,355336,1264644,145196,560,1450072,24128532
2024-11-20 05:24:23,1858332,38800,464,197036,15376,1001944,365524,951848,317928,50096,47596,520908,355348,1267948,146312,560,1450072,22208340
2024-11-20 05:24:25,1858332,76936,356,182020,15364,979852,354072,938596,312752,41256,41320,520908,348952,1249824,137564,560,1450072,20285956
2024-11-20 05:24:28,1858332,77224,356,182096,15364,980156,354112,938900,312716,41256,41396,520908,348952,1250064,137280,560,1450072,20285960
2024-11-20 05:24:30,1858332,77092,364,182296,15364,980404,354264,939148,312660,41256,41604,520908,348956,1249940,137376,560,1450072,20285876
2024-11-20 05:24:33,1858332,76796,364,182296,15364,980572,354268,939316,312664,41256,41604,520908,348960,1250412,137296,560,1450072,20286040
2024-11-20 05:24:35,1858332,76072,364,183428,15364,980704,355192,939448,312456,41256,42736,520908,348980,1250116,137516,560,1450072,20286028
2024-11-20 05:24:38,1858332,75792,364,183428,15364,981036,355192,939780,312456,41256,42736,520908,348980,1250520,137436,560,1450072,20286036
2024-11-20 05:24:40,1858332,66936,368,192116,15368,981456,363872,940200,312460,41256,51412,520908,348984,1251064,137704,560,1450072,20286036
2024-11-20 05:24:43,1858332,66556,368,192116,15368,981728,363888,940472,312460,41256,51428,520908,349000,1251316,137648,560,1450072,20286008
2024-11-20 05:24:45,1858332,66552,368,192116,15368,981828,363888,940572,312460,41256,51428,520908,349000,1251412,137748,560,1450072,20285848
2024-11-20 05:24:47,1858332,66268,368,192116,15368,981808,363888,940552,312460,41256,51428,520908,349004,1251360,137648,560,1450072,20285960
2024-11-20 05:24:50,1858332,65908,368,192116,15368,982376,363872,941120,312444,41256,51428,520908,349016,1251856,137748,560,1450072,20285928
2024-11-20 05:24:52,1858332,65908,368,192116,15368,982164,363872,940908,312444,41256,51428,520908,349016,1251844,138016,560,1450072,20285892
2024-11-20 05:24:55,1858332,65784,368,192116,15368,982636,363872,941380,312444,41256,51428,520908,349016,1252068,137736,560,1450072,20285960
2024-11-20 05:24:58,1858332,65104,368,192560,15368,982532,364324,941276,312452,41256,51872,520908,349024,1252008,137740,560,1450072,20286080
2024-11-20 05:25:00,1858332,64704,368,192560,15368,982740,364324,941484,312452,41256,51872,520908,349024,1252312,137640,560,1450072,20285940
2024-11-20 05:25:03,1858332,64964,368,192560,15368,982824,364324,941568,312452,41256,51872,520908,349024,1252308,137740,560,1450072,20286192
2024-11-20 05:25:05,1858332,64084,368,192560,15368,983444,364324,942188,312452,41256,51872,520908,349024,1252924,137904,560,1450072,20285992
2024-11-20 05:25:08,1858332,63744,368,192560,15368,983880,364324,942624,312452,41256,51872,520908,349024,1253324,137788,560,1450072,20286056
2024-11-20 05:25:11,1858332,63184,368,192560,15368,984168,364324,942912,312452,41256,51872,520908,349024,1253732,138112,560,1450072,20286084
2024-11-20 05:25:13,1858332,63052,368,192560,15368,984712,364320,943456,312448,41256,51872,520908,349024,1254144,137892,560,1450072,20286028
2024-11-20 05:25:16,1858332,69556,368,192560,15368,978468,363984,937212,312112,41256,51872,520908,349060,1247636,136828,560,1450072,20286072
2024-11-20 05:25:18,1858332,68844,368,192560,15368,978636,363972,937380,312100,41256,51872,520908,349064,1247716,137068,560,1450072,20286060
2024-11-20 05:25:20,1858332,68664,368,192560,15368,979016,363972,937760,312100,41256,51872,520908,349064,1247860,137028,560,1450072,20286056
2024-11-20 05:25:23,1858332,64836,368,195872,15456,979580,367164,938324,312136,41256,55028,520908,349144,1248844,137580,560,1450072,20285972
2024-11-20 05:25:25,1858332,64440,368,195892,15456,979436,367472,938180,312268,41256,55204,520908,349144,1248820,137556,560,1450072,20286000
2024-11-20 05:25:28,1858332,61964,368,197364,15456,980232,368836,938976,312268,41256,56568,520908,349144,1249404,137828,560,1450072,22205820
2024-11-20 05:25:31,1858332,55404,376,197372,15476,986372,368952,945088,312292,41284,56660,520908,349320,1256104,142772,560,1450072,24127468
2024-11-20 05:25:33,1858332,42916,384,198228,15476,997680,369848,956364,312360,41316,57488,520908,349328,1267204,147680,568,1450072,24128920
2024-11-20 05:25:36,1858332,19244,444,197944,15576,1005772,366228,956784,316736,48988,49492,520908,349368,1267308,148360,560,1450072,24129772
2024-11-20 05:25:39,1858332,62500,448,182384,15260,979668,350528,932224,315004,47444,35524,520908,344168,1245528,138160,512,1450072,20294128
2024-11-20 05:25:41,1858332,62376,456,182460,15260,980076,350708,932596,315020,47480,35688,520908,344168,1245892,138076,508,1450072,20294304
2024-11-20 05:25:44,1858332,62404,456,182460,15260,980132,350708,932652,315020,47480,35688,520908,344280,1245780,138344,508,1450072,20294268
2024-11-20 05:25:46,1858332,65408,456,182460,15260,976952,350708,929472,315020,47480,35688,520908,344284,1242696,137424,508,1450072,20294260
2024-11-20 05:25:49,1858332,64848,456,182460,15260,977108,350712,929628,315024,47480,35688,520908,344284,1242876,137500,508,1450072,20293952
2024-11-20 05:25:51,1858332,64648,464,182460,15260,977456,350644,929976,314948,47480,35696,520908,344288,1243204,137408,508,1450072,20294176
2024-11-20 05:25:54,1858332,64824,464,182456,15264,977664,350648,930184,314952,47480,35696,520908,344320,1243472,137444,508,1450072,20294152
2024-11-20 05:25:57,1858332,64988,464,182460,15264,977692,350640,930212,314944,47480,35696,520908,344320,1243380,137592,508,1450072,20294104
2024-11-20 05:25:59,1858332,64884,464,182460,15264,978044,350636,930564,314940,47480,35696,520908,344320,1243820,137468,508,1450072,20294132
2024-11-20 05:26:02,1858332,64716,464,182460,15264,977996,350632,930516,314936,47480,35696,520908,344320,1243668,137408,508,1450072,20294184
2024-11-20 05:26:04,1858332,64528,464,182460,15264,978252,350628,930772,314932,47480,35696,520908,344320,1244196,137472,508,1450072,20294276
2024-11-20 05:26:07,1858332,64580,464,182460,15264,978432,350436,930952,314740,47480,35696,520908,344320,1244164,137408,508,1450072,20294268
2024-11-20 05:26:09,1858332,64148,464,182460,15264,978720,350436,931240,314740,47480,35696,520908,344324,1244216,137592,508,1450072,20294244
2024-11-20 05:26:12,1858332,63680,464,182460,15264,979012,350436,931532,314740,47480,35696,520908,344352,1244780,137376,508,1450072,20294196
2024-11-20 05:26:14,1858332,63396,464,182460,15264,979088,350436,931608,314740,47480,35696,520908,344352,1244988,137612,508,1450072,20294292
2024-11-20 05:26:17,1858332,62832,464,182888,15268,979880,350872,932400,314748,47480,36124,520908,344356,1245416,137508,508,1450072,20294252
2024-11-20 05:26:20,1858332,61484,464,183528,15268,980456,351492,932976,314752,47480,36740,520908,344360,1245912,137468,508,1450072,20294216
2024-11-20 05:26:22,1858332,61232,464,183528,15268,980708,351516,933228,314752,47480,36764,520908,344368,1246228,137552,508,1450072,20294152
2024-11-20 05:26:25,1858332,61104,464,183528,15268,980824,351516,933344,314752,47480,36764,520908,344368,1246744,137468,508,1450072,20294228
2024-11-20 05:26:27,1858332,56132,464,183528,15268,985300,351516,937820,314752,47480,36764,520908,344368,1250980,137652,508,1450072,20294148
2024-11-20 05:26:30,1858332,53248,464,183632,15268,988472,351572,940992,314752,47480,36820,520908,344368,1254020,137660,508,1450072,20294364
2024-11-20 05:26:32,1858332,53228,464,183632,15268,988224,351620,940744,314752,47480,36868,520908,344376,1254052,137576,508,1450072,20294288
2024-11-20 05:26:35,1858332,52792,464,183632,15268,988624,351620,941144,314752,47480,36868,520908,344376,1254116,137476,508,1450072,20294412
2024-11-20 05:26:37,1858332,52864,464,183632,15268,988612,351620,941132,314752,47480,36868,520908,344376,1254180,137476,508,1450072,20294280
2024-11-20 05:26:40,1858332,52204,464,183632,15268,989256,351620,941776,314752,47480,36868,520908,344376,1254780,137476,508,1450072,20294236
2024-11-20 05:26:42,1858332,52092,464,183632,15268,989280,351624,941800,314756,47480,36868,520908,344380,1254816,137424,508,1450072,20294200
2024-11-20 05:26:45,1858332,52104,464,183632,15268,989592,351624,942112,314756,47480,36868,520908,344380,1254976,137660,508,1450072,20294116
2024-11-20 05:26:47,1858332,52312,464,183632,15268,989524,351624,942044,314756,47480,36868,520908,344380,1255144,137520,508,1450072,20294112
2024-11-20 05:26:50,1858332,52276,464,183632,15268,989768,351624,942288,314756,47480,36868,520908,344380,1255320,137584,508,1450072,20294168
2024-11-20 05:26:53,1858332,51612,464,183632,15268,990076,351624,942596,314756,47480,36868,520908,344380,1255448,137660,508,1450072,20294184
2024-11-20 05:26:55,1858332,51216,464,183632,15268,989924,351624,942444,314756,47480,36868,520908,344380,1255508,137612,508,1450072,20294220
2024-11-20 05:26:58,1858332,51136,464,183632,15268,990248,351624,942768,314756,47480,36868,520908,344400,1255748,137296,508,1450072,20294040
2024-11-20 05:27:00,1858332,50848,464,183632,15268,990560,351624,943080,314756,47480,36868,520908,344400,1256220,137484,508,1450072,20294232
2024-11-20 05:27:03,1858332,50552,464,183632,15268,990692,351628,943212,314760,47480,36868,520908,344404,1256100,137704,508,1450072,20294180
2024-11-20 05:27:06,1858332,50436,464,183632,15268,991188,351628,943708,314760,47480,36868,520908,344404,1256688,137504,508,1450072,20294332
2024-11-20 05:27:08,1858332,56288,464,183632,15268,984624,351628,937144,314760,47480,36868,520908,344412,1250240,137620,508,1450072,20294168
2024-11-20 05:27:11,1858332,56680,464,183632,15268,984848,351628,937368,314760,47480,36868,520908,344412,1250420,137504,508,1450072,20294264
2024-11-20 05:27:13,1858332,56248,464,183632,15268,984920,351628,937440,314760,47480,36868,520908,344412,1250668,137476,508,1450072,20294176
2024-11-20 05:27:16,1858332,55924,464,183700,15268,985180,351684,937700,314760,47480,36924,520908,344412,1250716,137508,508,1450072,20294248
2024-11-20 05:27:18,1858332,57192,464,183700,15268,984380,351072,936900,314136,47480,36936,520908,344468,1249332,137692,508,1450072,20294196
2024-11-20 05:27:21,1858332,57052,464,183700,15268,984392,351072,936912,314136,47480,36936,520908,344468,1249372,137564,508,1450072,20294232
2024-11-20 05:27:24,1858332,57180,464,183808,15264,984588,351180,937108,314136,47480,37044,520908,344472,1249556,137328,508,1450072,20294236
2024-11-20 05:27:26,1858332,57376,464,183808,15264,984480,351180,937000,314136,47480,37044,520908,344472,1249604,137500,508,1450072,20294228
2024-11-20 05:27:29,1858332,57260,464,183808,15264,984448,351180,936968,314136,47480,37044,520908,344484,1249420,137700,508,1450072,20294056
2024-11-20 05:27:31,1858332,56460,464,183808,15264,985212,351188,937732,314144,47480,37044,520908,344488,1250012,137576,508,1450072,20294164
2024-11-20 05:27:34,1858332,56528,464,183808,15264,985320,351188,937840,314144,47480,37044,520908,344488,1250252,137516,508,1450072,20294216
2024-11-20 05:27:36,1858332,53472,464,184964,15264,987424,352296,939944,314148,47480,38148,520908,344492,1252472,137812,508,1450072,20295740
2024-11-20 05:27:38,1858332,53056,464,184964,15264,987416,352344,939936,314148,47480,38196,520908,344492,1252324,137660,508,1450072,20312016
2024-11-20 05:27:41,1858332,53004,464,184964,15264,987704,352348,940224,314148,47480,38200,520908,344492,1252756,137844,508,1450072,20312172
2024-11-20 05:27:43,1858332,52728,464,184964,15264,987868,352348,940388,314148,47480,38200,520908,344492,1252780,137708,508,1450072,20311968
2024-11-20 05:27:46,1858332,52576,464,184964,15264,988036,352348,940556,314148,47480,38200,520908,344508,1253084,137672,508,1450072,20312132
2024-11-20 05:27:48,1858332,51900,464,184964,15264,988736,352348,941256,314148,47480,38200,520908,344508,1253648,137508,508,1450072,20312088
2024-11-20 05:27:51,1858332,51836,464,184968,15260,988896,352348,941416,314148,47480,38200,520908,344516,1253608,137708,508,1450072,20312100
2024-11-20 05:27:54,1858332,51460,464,184964,15260,988828,352348,941348,314148,47480,38200,520908,344516,1253792,137664,508,1450072,20311952
2024-11-20 05:27:57,1858332,50996,464,184964,15260,989412,352348,941932,314148,47480,38200,520908,344516,1254564,137664,508,1450072,20312208
2024-11-20 05:27:59,1858332,50692,464,184964,15260,989832,352348,942352,314148,47480,38200,520908,344516,1254852,137744,508,1450072,20312276
2024-11-20 05:28:02,1858332,50324,464,184964,15260,989876,352348,942396,314148,47480,38200,520908,344516,1254988,137664,508,1450072,20312204
2024-11-20 05:28:04,1858332,50140,464,184964,15260,990444,352348,942964,314148,47480,38200,520908,344516,1255356,137664,508,1450072,20312052
2024-11-20 05:28:07,1858332,50244,464,184964,15260,990384,352348,942904,314148,47480,38200,520908,344516,1255404,137664,508,1450072,20312116
2024-11-20 05:28:09,1858332,49496,464,184964,15260,991056,352348,943576,314148,47480,38200,520908,344516,1255952,137664,508,1450072,20312068
2024-11-20 05:28:12,1858332,49004,464,184964,15260,991356,352348,943876,314148,47480,38200,520908,344516,1256436,137848,508,1450072,20312104
2024-11-20 05:28:14,1858332,49412,464,184964,15260,991376,352348,943896,314148,47480,38200,520908,344516,1256316,137720,508,1450072,20312024
2024-11-20 05:28:17,1858332,49140,464,184964,15272,991664,352376,944184,314176,47480,38200,520908,344532,1256708,137548,508,1450072,20311960
2024-11-20 05:28:20,1858332,55020,464,184964,15272,985776,352376,938296,314176,47480,38200,520908,344536,1250672,137760,508,1450072,20312088
2024-11-20 05:28:22,1858332,54468,464,184964,15272,986344,352380,938864,314180,47480,38200,520908,344540,1251324,137868,508,1450072,20312216
2024-11-20 05:28:24,1858332,54404,464,184964,15272,986428,352380,938948,314180,47480,38200,520908,344540,1251332,137548,508,1450072,20312076
2024-11-20 05:28:27,1858332,54196,464,184964,15272,986580,352380,939100,314180,47480,38200,520908,344540,1251656,137916,508,1450072,20312068
2024-11-20 05:28:29,1858332,54268,464,184964,15272,986964,352380,939484,314180,47480,38200,520908,344540,1251908,137732,508,1450072,20312260
2024-11-20 05:28:32,1858332,53596,464,184964,15272,987532,352380,940052,314180,47480,38200,520908,344540,1252472,137916,508,1450072,20312204
2024-11-20 05:28:34,1858332,53984,464,184964,15272,987312,352380,939832,314180,47480,38200,520908,344540,1252312,137620,508,1450072,20312168
2024-11-20 05:28:37,1858332,53456,464,184964,15272,987456,352380,939976,314180,47480,38200,520908,344540,1252456,137732,508,1450072,20312184
2024-11-20 05:28:40,1858332,53052,464,184964,15272,987940,352380,940460,314180,47480,38200,520908,344540,1252912,137916,508,1450072,20312300
2024-11-20 05:28:42,1858332,52480,464,184964,15272,988020,352380,940540,314180,47480,38200,520908,344540,1253144,137816,508,1450072,20312144
2024-11-20 05:28:45,1858332,52456,464,184964,15272,988308,352380,940828,314180,47480,38200,520908,344540,1253320,137916,508,1450072,20312084
2024-11-20 05:28:47,1858332,52608,464,184964,15272,988300,352380,940820,314180,47480,38200,520908,344540,1253116,137680,508,1450072,20312040
2024-11-20 05:28:50,1858332,52636,464,184964,15272,988232,352380,940752,314180,47480,38200,520908,344540,1253424,137732,508,1450072,20312116
2024-11-20 05:28:52,1858332,52544,572,184968,15272,988672,352488,941172,314196,47500,38292,520908,344556,1253784,137660,508,1450072,20312160
2024-11-20 05:28:55,1858332,51748,588,185028,15272,989380,352544,941864,314196,47516,38348,520908,344556,1254240,137892,508,1450072,20312044
2024-11-20 05:28:58,1858332,51284,588,185028,15272,989832,352548,942316,314196,47516,38352,520908,344556,1254748,137928,508,1450072,20312060
2024-11-20 05:29:00,1858332,50332,596,185028,15272,990888,352564,943372,314204,47516,38360,520908,344564,1255828,137660,508,1450072,20312048
2024-11-20 05:29:03,1858332,49648,596,185028,15272,991436,352564,943920,314204,47516,38360,520908,344564,1256580,137828,508,1450072,20312084
2024-11-20 05:29:06,1858332,49168,596,185028,15272,991664,352564,944148,314204,47516,38360,520908,344564,1256732,137560,508,1450072,20312028
2024-11-20 05:29:08,1858332,49224,596,185028,15272,991676,352564,944160,314204,47516,38360,520908,344564,1256612,137824,508,1450072,20312156
2024-11-20 05:29:11,1858332,48692,596,185028,15272,992208,352564,944692,314204,47516,38360,520908,344564,1256892,137928,508,1450072,20312308
2024-11-20 05:29:13,1858332,49060,596,185028,15272,992024,352564,944508,314204,47516,38360,520908,344564,1256988,137864,508,1450072,20311976
2024-11-20 05:29:16,1858332,48796,596,185028,15272,992632,352564,945116,314204,47516,38360,520908,344564,1257524,137928,508,1450072,20312040
2024-11-20 05:29:18,1858332,55364,596,185028,15272,985492,352564,937976,314204,47516,38360,520908,344564,1250396,138000,508,1450072,20312232
2024-11-20 05:29:21,1858332,55116,596,185028,15272,985704,352564,938188,314204,47516,38360,520908,344588,1250540,137776,508,1450072,20312156
2024-11-20 05:29:23,1858332,55256,596,185028,15272,985540,352564,938024,314204,47516,38360,520908,344588,1250528,137744,508,1450072,20312220
2024-11-20 05:29:26,1858332,54556,596,185028,15272,985920,352564,938404,314204,47516,38360,520908,344588,1251076,137928,508,1450072,20312140
2024-11-20 05:29:29,1858332,54544,596,185028,15272,986092,352564,938576,314204,47516,38360,520908,344588,1251164,137724,508,1450072,20312140
2024-11-20 05:29:31,1858332,54232,596,185028,15272,986040,352564,938524,314204,47516,38360,520908,344588,1251196,137844,508,1450072,20312160
2024-11-20 05:29:34,1858332,54364,596,185028,15272,986284,352564,938768,314204,47516,38360,520908,344588,1251204,137744,508,1450072,20312320
2024-11-20 05:29:36,1858332,54392,596,185028,15272,986560,352564,939044,314204,47516,38360,520908,344588,1251740,137836,508,1450072,20312008
2024-11-20 05:29:39,1858332,55044,596,185028,15272,986484,352068,938968,313708,47516,38360,520908,344588,1251100,137744,508,1450072,20312076
2024-11-20 05:29:41,1858332,54864,596,185028,15272,986828,352028,939312,313668,47516,38360,520908,344588,1251172,137900,508,1450072,20312320
2024-11-20 05:29:44,1858332,54452,596,185028,15272,986920,352028,939404,313668,47516,38360,520908,344588,1251320,137928,508,1450072,20312028
2024-11-20 05:29:46,1858332,54464,596,185028,15272,987196,352028,939680,313668,47516,38360,520908,344588,1251584,137924,508,1450072,20312168
2024-11-20 05:29:49,1858332,54696,596,185028,15272,987152,352028,939636,313668,47516,38360,520908,344588,1251528,137784,508,1450072,20312112
2024-11-20 05:29:52,1858332,54084,596,185032,15268,987488,352028,939972,313668,47516,38360,520908,344680,1251940,137744,508,1450072,20312148
2024-11-20 05:29:54,1858332,51844,596,185396,15268,988944,352404,941428,313672,47516,38732,520908,344692,1253668,138500,508,1450072,22232024
2024-11-20 05:29:57,1858332,43492,620,186360,15348,995128,353608,947612,313892,47516,39716,520908,344972,1259884,143240,508,1450072,24153508
2024-11-20 05:30:00,1858332,32376,640,186732,15344,1005724,353916,958240,313904,47484,40012,520908,345000,1270588,147800,508,1450072,24154800
2024-11-20 05:30:02,1858332,53660,640,185792,15244,986732,355128,939048,316128,47684,39000,520908,344664,1253480,138688,508,1450072,20312292
2024-11-20 05:30:05,1858332,52988,648,185784,15244,987520,354972,939788,316020,47732,38952,520908,344664,1253888,138624,508,1450072,20312196
2024-11-20 05:30:07,1858332,52796,648,185792,15244,987732,354924,940000,315964,47732,38960,520908,344664,1254228,138688,508,1450072,20312116
2024-11-20 05:30:10,1858332,56832,648,185792,15244,983716,354880,935984,315920,47732,38960,520908,344664,1250040,137856,508,1450072,20312132
2024-11-20 05:30:13,1858332,53056,696,187304,15424,985916,356724,938136,316332,47780,40392,520908,347284,1252792,138484,568,1450072,20312096
2024-11-20 05:30:15,1858332,53312,696,187308,15424,985784,356736,938004,316320,47780,40416,520908,347284,1252416,138552,568,1450072,20312096
2024-11-20 05:30:18,1858332,52700,696,187308,15424,986228,356740,938448,316324,47780,40416,520908,347288,1252832,138540,568,1450072,20312336
2024-11-20 05:30:20,1858332,52420,708,187316,15424,986512,356772,938728,316340,47784,40432,520908,347304,1253316,138416,568,1450072,20312212
2024-11-20 05:30:23,1858332,51792,708,187316,15424,986780,356772,938996,316340,47784,40432,520908,347304,1253516,138364,568,1450072,20312144
2024-11-20 05:30:26,1858332,51528,716,187308,15424,986972,356776,939188,316344,47784,40432,520908,347308,1253916,138548,568,1450072,20312252
2024-11-20 05:30:28,1858332,51920,716,187316,15424,987044,356784,939260,316344,47784,40440,520908,347308,1253728,138588,568,1450072,20312084
2024-11-20 05:30:31,1858332,51716,716,187412,15424,987364,356840,939580,316344,47784,40496,520908,347308,1253980,138380,568,1450072,20312024
2024-11-20 05:30:33,1858332,51528,716,187412,15424,987648,356880,939864,316344,47784,40536,520908,347308,1254372,138564,568,1450072,20312052
2024-11-20 05:30:36,1858332,50920,716,187412,15424,987732,356884,939948,316348,47784,40536,520908,347316,1254552,138384,568,1450072,20311988
2024-11-20 05:30:38,1858332,50868,716,187412,15424,988048,356888,940264,316352,47784,40536,520908,347320,1254772,138596,568,1450072,20312156
2024-11-20 05:30:41,1858332,50612,716,187412,15424,988268,356888,940484,316352,47784,40536,520908,347320,1254884,138568,568,1450072,20312208
2024-11-20 05:30:43,1858332,50240,716,187412,15424,988468,356888,940684,316352,47784,40536,520908,347320,1255344,138476,568,1450072,20312240
2024-11-20 05:30:46,1858332,50248,716,187412,15424,988432,356888,940648,316352,47784,40536,520908,347320,1255144,138568,568,1450072,20312148
2024-11-20 05:30:48,1858332,49816,716,187412,15424,988464,356888,940680,316352,47784,40536,520908,347320,1255360,138568,568,1450072,20312220
2024-11-20 05:30:51,1858332,49888,716,187412,15424,988824,356888,941040,316352,47784,40536,520908,347320,1255612,138568,568,1450072,20312156
2024-11-20 05:30:53,1858332,49564,716,187412,15424,988852,356888,941068,316352,47784,40536,520908,347320,1255312,138428,568,1450072,20312192
2024-11-20 05:30:56,1858332,49468,716,187412,15424,989432,356888,941648,316352,47784,40536,520908,347320,1256128,138568,568,1450072,20312176
2024-11-20 05:30:58,1858332,48756,716,187412,15424,989552,356884,941768,316348,47784,40536,520908,347320,1256384,138612,568,1450072,20312200
2024-11-20 05:31:01,1858332,48820,716,187412,15424,989476,356884,941692,316348,47784,40536,520908,347320,1256184,138384,568,1450072,20303912
2024-11-20 05:31:03,1858332,48760,716,187412,15424,989728,356884,941944,316348,47784,40536,520908,347320,1256328,138428,568,1450072,20312160
2024-11-20 05:31:06,1858332,48524,716,187412,15424,989764,356884,941980,316348,47784,40536,520908,347320,1256492,138384,568,1450072,20312100
2024-11-20 05:31:08,1858332,48632,716,187412,15424,990180,356884,942396,316348,47784,40536,520908,347320,1256844,138588,568,1450072,20312088
2024-11-20 05:31:11,1858332,48292,716,187412,15424,990224,356884,942440,316348,47784,40536,520908,347320,1256992,138568,568,1450072,20312200
2024-11-20 05:31:13,1858332,48056,716,187412,15424,990192,356884,942408,316348,47784,40536,520908,347320,1257036,138584,568,1450072,20311940
2024-11-20 05:31:16,1858332,47932,716,187412,15424,990720,356884,942936,316348,47784,40536,520908,347320,1257332,138568,568,1450072,20312028
2024-11-20 05:31:18,1858332,47700,716,187412,15424,990832,356884,943048,316348,47784,40536,520908,347320,1257548,138588,568,1450072,20312064
2024-11-20 05:31:21,1858332,47604,716,187412,15424,990980,356884,943196,316348,47784,40536,520908,347320,1257584,138568,568,1450072,20311884
2024-11-20 05:31:23,1858332,47564,716,187412,15424,991216,356884,943432,316348,47784,40536,520908,347320,1257856,138588,568,1450072,20312036
2024-11-20 05:31:26,1858332,47276,716,187412,15424,991264,356884,943480,316348,47784,40536,520908,347320,1257848,138384,568,1450072,20312044
2024-11-20 05:31:28,1858332,47120,716,187412,15424,991344,356884,943560,316348,47784,40536,520908,347320,1258112,138436,568,1450072,20312180
2024-11-20 05:31:31,1858332,47052,716,187412,15424,991736,356884,943952,316348,47784,40536,520908,347320,1258356,138568,568,1450072,20312076
2024-11-20 05:31:34,1858332,46324,716,187408,15428,991912,356884,944128,316348,47784,40536,520908,347320,1258728,138384,568,1450072,20312272
2024-11-20 05:31:36,1858332,45676,716,187412,15428,992788,356888,945004,316352,47784,40536,520908,347320,1259612,138592,568,1450072,20312148
2024-11-20 05:31:39,1858332,51448,716,187412,15428,986760,356888,938976,316352,47784,40536,520908,347332,1253468,138572,568,1450072,20312044
2024-11-20 05:31:41,1858332,51072,716,187412,15428,987188,356896,939404,316360,47784,40536,520908,347332,1254108,138440,568,1450072,20312268
2024-11-20 05:31:44,1858332,51160,716,187412,15428,987228,356896,939444,316360,47784,40536,520908,347332,1253892,138512,568,1450072,20312256
2024-11-20 05:31:46,1858332,51032,716,187412,15428,987304,356896,939520,316360,47784,40536,520908,347332,1254044,138388,568,1450072,20312176
2024-11-20 05:31:49,1858332,50828,716,187412,15428,987472,356896,939688,316360,47784,40536,520908,347332,1254476,138388,568,1450072,20312096
2024-11-20 05:31:51,1858332,50400,716,187412,15428,987656,356896,939872,316360,47784,40536,520908,347332,1254580,138620,568,1450072,20312168
2024-11-20 05:31:54,1858332,50428,716,187412,15428,987772,356896,939988,316360,47784,40536,520908,347332,1254552,138572,568,1450072,20312128
2024-11-20 05:31:56,1858332,50744,716,187412,15428,988068,356896,940284,316360,47784,40536,520908,347332,1254944,138624,568,1450072,20312072
2024-11-20 05:31:59,1858332,50344,716,187412,15428,988340,356892,940556,316356,47784,40536,520908,347360,1255240,138388,568,1450072,20312292
2024-11-20 05:32:01,1858332,49916,716,187412,15428,988764,356892,940980,316356,47784,40536,520908,347360,1255336,138436,568,1450072,20312220
2024-11-20 05:32:04,1858332,49680,716,187412,15428,988592,356892,940808,316356,47784,40536,520908,347360,1255312,138572,568,1450072,20304060
2024-11-20 05:32:06,1858332,49384,716,187412,15428,988836,356892,941052,316356,47784,40536,520908,347360,1255792,138592,568,1450072,20312104
2024-11-20 05:32:09,1858332,49556,716,187412,15428,989108,356892,941324,316356,47784,40536,520908,347360,1255576,138572,568,1450072,20312136
2024-11-20 05:32:11,1858332,49364,716,187412,15428,989120,356892,941336,316356,47784,40536,520908,347360,1255864,138572,568,1450072,20312176
2024-11-20 05:32:14,1858332,48896,716,187412,15428,989460,356892,941676,316356,47784,40536,520908,347360,1256268,138572,568,1450072,20312072
2024-11-20 05:32:16,1858332,49048,716,187412,15428,989596,356892,941812,316356,47784,40536,520908,347360,1256276,138576,568,1450072,20312056
2024-11-20 05:32:19,1858332,48836,716,187412,15428,989700,356892,941916,316356,47784,40536,520908,347360,1256296,138388,568,1450072,20312128
2024-11-20 05:32:21,1858332,48368,716,187412,15428,990068,356892,942284,316356,47784,40536,520908,347360,1256500,138572,568,1450072,20312188
2024-11-20 05:32:24,1858332,48464,716,187412,15428,990104,356892,942320,316356,47784,40536,520908,347360,1256756,138572,568,1450072,20312168
2024-11-20 05:32:26,1858332,48188,716,187412,15428,990120,356892,942336,316356,47784,40536,520908,347360,1257088,138572,568,1450072,20312060
2024-11-20 05:32:29,1858332,48352,716,187412,15428,990460,356892,942676,316356,47784,40536,520908,347360,1257216,138572,568,1450072,20312068
2024-11-20 05:32:31,1858332,47380,716,187412,15428,990708,356892,942924,316356,47784,40536,520908,347360,1257432,138440,568,1450072,20312140
2024-11-20 05:32:34,1858332,47724,716,187412,15428,990504,356892,942720,316356,47784,40536,520908,347360,1257528,138572,568,1450072,20312048
2024-11-20 05:32:36,1858332,47240,716,187412,15428,990964,356892,943180,316356,47784,40536,520908,347360,1257672,138620,568,1450072,20312020
2024-11-20 05:32:39,1858332,47420,716,187412,15428,990900,356892,943116,316356,47784,40536,520908,347360,1257616,138384,568,1450072,20312140
2024-11-20 05:32:41,1858332,46984,716,187412,15428,991156,356896,943372,316360,47784,40536,520908,347364,1257904,138568,568,1450072,20312188
2024-11-20 05:32:44,1858332,46816,716,187412,15428,991424,356896,943640,316360,47784,40536,520908,347364,1258140,138588,568,1450072,20312120
2024-11-20 05:32:47,1858332,46296,716,187412,15428,991912,356900,944128,316364,47784,40536,520908,347368,1258964,138384,568,1450072,20312120
2024-11-20 05:32:49,1858332,46100,716,187412,15428,992336,356900,944552,316364,47784,40536,520908,347368,1259084,138620,568,1450072,20312048
2024-11-20 05:32:52,1858332,45224,716,187412,15428,992940,356900,945156,316364,47784,40536,520908,347368,1259716,138572,568,1450072,20312080
2024-11-20 05:32:54,1858332,52220,716,187412,15428,985872,356900,938088,316364,47784,40536,520908,347368,1252680,138572,568,1450072,20312028
2024-11-20 05:32:57,1858332,52192,716,187412,15428,986552,356900,938768,316364,47784,40536,520908,347368,1253320,138552,568,1450072,20312060
2024-11-20 05:33:00,1858332,51604,716,187412,15428,987268,356900,939484,316364,47784,40536,520908,347368,1254064,138572,568,1450072,20312080
2024-11-20 05:33:02,1858332,50940,716,187412,15428,987708,356900,939924,316364,47784,40536,520908,347368,1254596,138440,568,1450072,20312212
2024-11-20 05:33:05,1858332,50680,716,187412,15428,988132,356900,940348,316364,47784,40536,520908,347368,1254776,138388,568,1450072,20312160
2024-11-20 05:33:07,1858332,50628,716,187412,15428,987932,356900,940148,316364,47784,40536,520908,347368,1254832,138576,568,1450072,20312164
2024-11-20 05:33:10,1858332,50336,716,187412,15428,988492,356900,940708,316364,47784,40536,520908,347368,1255200,138628,568,1450072,20312184
2024-11-20 05:33:13,1858332,50112,716,187412,15428,989000,356900,941216,316364,47784,40536,520908,347368,1255672,138392,568,1450072,20312128
2024-11-20 05:33:15,1858332,49728,716,187412,15428,989072,356900,941288,316364,47784,40536,520908,347368,1255856,138576,568,1450072,20312192
2024-11-20 05:33:18,1858332,49500,716,187412,15428,989200,356900,941416,316364,47784,40536,520908,347368,1256116,138576,568,1450072,20312060
2024-11-20 05:33:20,1858332,49364,716,187412,15428,989640,356900,941856,316364,47784,40536,520908,347368,1256168,138588,568,1450072,20311964
2024-11-20 05:33:22,1858332,49472,716,187412,15428,989596,356900,941812,316364,47784,40536,520908,347368,1256380,138576,568,1450072,20312132
2024-11-20 05:33:25,1858332,48912,716,187412,15428,989916,356900,942132,316364,47784,40536,520908,347368,1256700,138576,568,1450072,20312068
2024-11-20 05:33:27,1858332,48448,716,187412,15428,990016,356900,942232,316364,47784,40536,520908,347368,1256968,138576,568,1450072,20312212
2024-11-20 05:33:30,1858332,36584,724,201284,15332,990932,370252,943032,315960,47900,54292,520908,347216,1257228,138896,568,1450072,20312172
2024-11-20 05:33:32,1858332,36300,724,201284,15332,990844,370252,942944,315960,47900,54292,520908,347216,1257188,139088,568,1450072,20312228
2024-11-20 05:33:35,1858332,36212,732,201276,15332,991204,370260,943304,315960,47900,54300,520908,347216,1257488,139088,568,1450072,20312124
2024-11-20 05:33:37,1858332,36068,732,201284,15332,991464,370276,943564,315968,47900,54308,520908,347224,1257740,138956,568,1450072,20312304
2024-11-20 05:33:40,1858332,35644,732,201284,15332,991724,370276,943824,315968,47900,54308,520908,347224,1257988,139088,568,1450072,20312140
2024-11-20 05:33:43,1858332,35848,732,201284,15332,991992,370276,944092,315968,47900,54308,520908,347224,1258236,139088,568,1450072,20312120
2024-11-20 05:33:45,1858332,35436,732,201284,15332,992328,370276,944428,315968,47900,54308,520908,347224,1258440,139008,568,1450072,20312040
2024-11-20 05:33:48,1858332,35264,732,201284,15332,992268,370276,944368,315968,47900,54308,520908,347224,1258492,139088,568,1450072,20312128
2024-11-20 05:33:50,1858332,35144,732,201284,15332,992384,370276,944484,315968,47900,54308,520908,347224,1258492,138904,568,1450072,20312200
2024-11-20 05:33:53,1858332,34816,732,201284,15332,992628,370276,944728,315968,47900,54308,520908,347224,1258932,139088,568,1450072,20312176
2024-11-20 05:33:55,1858332,34716,732,201284,15332,992504,370276,944604,315968,47900,54308,520908,347252,1258868,139088,568,1450072,20312116
2024-11-20 05:33:58,1858332,34344,732,201284,15328,993388,370276,945488,315968,47900,54308,520908,347256,1259804,139144,568,1450072,20312156
2024-11-20 05:34:01,1858332,40952,732,201284,15324,986492,370276,938592,315968,47900,54308,520908,347372,1252912,139104,568,1450072,20312140
2024-11-20 05:34:03,1858332,41236,732,201284,15324,986636,370276,938736,315968,47900,54308,520908,347372,1252896,138972,568,1450072,20312072
2024-11-20 05:34:06,1858332,40744,732,201284,15324,986600,370276,938700,315968,47900,54308,520908,347376,1252844,138920,568,1450072,20312008
2024-11-20 05:34:09,1858332,40688,732,201284,15324,986920,370276,939020,315968,47900,54308,520908,347376,1253172,139104,568,1450072,20312196
2024-11-20 05:34:11,1858332,40708,732,201284,15324,987216,370276,939316,315968,47900,54308,520908,347376,1253564,139044,568,1450072,20312164
2024-11-20 05:34:14,1858332,39844,732,201284,15324,987608,370276,939708,315968,47900,54308,520908,347376,1254076,139104,568,1450072,20312180
2024-11-20 05:34:16,1858332,39676,732,201284,15324,988004,370276,940104,315968,47900,54308,520908,347376,1254220,138972,568,1450072,20312280
2024-11-20 05:34:19,1858332,38736,732,201284,15324,989028,370276,941128,315968,47900,54308,520908,347384,1255320,139104,568,1450072,20312132
2024-11-20 05:34:21,1858332,38464,732,201284,15320,988928,370284,941028,315976,47900,54308,520908,347388,1255024,139104,568,1450072,20312152
2024-11-20 05:34:24,1858332,38524,732,201284,15320,989204,370284,941304,315976,47900,54308,520908,347388,1255480,139104,568,1450072,20312084
2024-11-20 05:34:26,1858332,37860,732,201284,15320,989764,370284,941864,315976,47900,54308,520908,347388,1256156,138972,568,1450072,20312116
2024-11-20 05:34:29,1858332,37756,732,201284,15320,990084,370284,942184,315976,47900,54308,520908,347388,1256348,139104,568,1450072,20312264
2024-11-20 05:34:31,1858332,37768,732,201284,15320,990140,370284,942240,315976,47900,54308,520908,347388,1256460,139108,568,1450072,20312212
2024-11-20 05:34:34,1858332,36984,732,201284,15320,990608,370284,942708,315976,47900,54308,520908,347388,1257060,139108,568,1450072,20311992
2024-11-20 05:34:36,1858332,36572,732,201284,15320,991052,370284,943152,315976,47900,54308,520908,347388,1257344,139116,568,1450072,20312004
2024-11-20 05:34:39,1858332,36384,732,201284,15320,991404,370284,943504,315976,47900,54308,520908,347388,1257440,139108,568,1450072,20312232
2024-11-20 05:34:41,1858332,36260,732,201284,15320,991556,370284,943656,315976,47900,54308,520908,347388,1257900,139160,568,1450072,20312020
2024-11-20 05:34:44,1858332,35724,732,201284,15320,992048,370284,944148,315976,47900,54308,520908,347388,1258188,139096,568,1450072,20312208
2024-11-20 05:34:47,1858332,34808,732,201284,15320,992676,370284,944776,315976,47900,54308,520908,347400,1258992,139112,568,1450072,20312200
2024-11-20 05:34:49,1858332,34544,732,201284,15320,992972,370284,945072,315976,47900,54308,520908,347400,1259284,139132,568,1450072,20312040
2024-11-20 05:34:52,1858332,33960,732,201284,15320,994208,370284,946308,315976,47900,54308,520908,347400,1260416,139096,568,1450072,20312148
2024-11-20 05:34:54,1858332,40140,732,201284,15320,987348,370288,939448,315980,47900,54308,520908,347404,1253668,139112,568,1450072,20312188
2024-11-20 05:34:57,1858332,39832,732,201648,15324,987988,370536,940088,315980,47900,54556,520908,347408,1254216,139132,568,1450072,20312020
2024-11-20 05:35:00,1858332,33788,732,200288,14936,994432,368952,946500,315708,47932,53244,520908,347656,1261156,143476,568,1450072,24151068
2024-11-20 05:35:03,1858332,35864,716,195352,14784,1001192,365420,952712,317592,48480,47828,520908,347228,1268956,147396,568,1450072,24156556
2024-11-20 05:35:06,1858332,34812,732,193204,14960,1003880,365760,956780,318992,47100,46768,520908,347024,1274380,150036,568,1450072,24155608
2024-11-20 05:35:08,1858332,49412,748,184100,14856,987356,356584,944720,314184,42636,42400,520908,346640,1257428,139940,568,1450072,22233376
2024-11-20 05:35:11,1858332,40868,780,184112,14948,994900,356216,951644,314388,43256,41828,520908,346800,1264452,144472,568,1450072,24154080
2024-11-20 05:35:14,1858332,35176,788,183084,14880,1004688,353916,957960,316580,46728,37336,520908,346520,1259400,143468,568,1450072,24155420
2024-11-20 05:35:17,1858332,52992,788,183084,14880,988384,353756,941476,316600,46908,37156,520908,346540,1256188,138708,568,1450072,20312204
2024-11-20 05:35:19,1858332,52976,796,183084,14880,988552,353764,941644,316600,46908,37164,520908,346540,1256264,138940,568,1450072,22051028
2024-11-20 05:35:22,1858332,44016,804,183572,14760,996200,354280,949292,316736,46908,37544,520908,346812,1264716,143196,568,1450072,24153344
2024-11-20 05:35:24,1858332,40632,804,183464,14628,999524,354224,952604,316684,46920,37540,520908,347172,1267676,147360,568,1450072,24156540
2024-11-20 05:35:27,1858332,36036,820,183472,14620,1005116,353212,957148,316696,47968,36516,520908,347192,1272564,149996,568,1450072,24155788
2024-11-20 05:35:30,1858332,54572,812,183956,14036,983752,354888,936440,317240,47312,37648,520908,346556,1252044,138912,568,1450072,20312180
2024-11-20 05:35:32,1858332,52528,968,183996,14040,985876,355048,938548,317244,47328,37804,520908,346584,1254144,140624,568,1450072,22232680
2024-11-20 05:35:35,1858332,51980,968,184100,14040,986108,355208,938760,317296,47348,37912,520908,346608,1254468,140636,568,1450072,22232412
2024-11-20 05:35:38,1858332,51636,968,184100,14040,986608,355208,939260,317296,47348,37912,520908,346608,1255164,140452,568,1450072,22232492
2024-11-20 05:35:40,1858332,50988,980,184100,14040,986988,355240,939640,317316,47348,37924,520908,346632,1255408,140640,568,1450072,22232396
2024-11-20 05:35:43,1858332,51100,980,184100,14040,986944,355240,939596,317316,47348,37924,520908,346632,1255304,140736,568,1450072,22232504
2024-11-20 05:35:46,1858332,46156,988,184100,14044,991480,355268,944132,317340,47348,37928,520908,346728,1259980,142824,568,1450072,24153776
2024-11-20 05:35:48,1858332,33500,1004,184100,14044,1002884,355424,955560,317452,47324,37972,520908,346764,1271676,148340,568,1450072,26075124
2024-11-20 05:35:51,1858332,55020,1004,183136,13616,985584,354932,938240,317916,47344,37016,520908,345864,1254428,138836,540,1450072,20312180
2024-11-20 05:35:53,1858332,55036,1004,183136,13616,985668,354932,938324,317916,47344,37016,520908,345864,1254556,138896,540,1450072,20312292
2024-11-20 05:35:56,1858332,54740,1012,183136,13616,986176,354940,938832,317916,47344,37024,520908,345864,1255032,138836,540,1450072,20312124
2024-11-20 05:35:59,1858332,54880,1012,183136,13616,986188,354940,938844,317916,47344,37024,520908,345864,1254888,138896,540,1450072,20312036
2024-11-20 05:36:01,1858332,54948,1020,183136,13616,986336,354948,938992,317916,47344,37032,520908,345864,1255264,138860,540,1450072,20312348
2024-11-20 05:36:04,1858332,54028,1020,183136,13616,986880,354948,939536,317916,47344,37032,520908,345864,1255744,138896,540,1450072,20312204
2024-11-20 05:36:06,1858332,53692,1020,183136,13616,986836,354948,939492,317916,47344,37032,520908,345864,1255840,138896,540,1450072,20312220
2024-11-20 05:36:09,1858332,53664,1020,183136,13616,987528,354948,940184,317916,47344,37032,520908,345868,1256556,138904,540,1450072,20312128
2024-11-20 05:36:11,1858332,53852,1020,183136,13616,987792,354952,940448,317920,47344,37032,520908,345868,1256624,138924,540,1450072,20304076
2024-11-20 05:36:13,1858332,53352,1020,183136,13616,987760,354952,940416,317920,47344,37032,520908,345868,1256944,138904,540,1450072,20312164
2024-11-20 05:36:16,1858332,53372,1020,183136,13616,988104,354952,940760,317920,47344,37032,520908,345868,1257068,138924,540,1450072,20312056
2024-11-20 05:36:19,1858332,56804,1020,183136,13616,984432,354952,937088,317920,47344,37032,520908,345868,1253148,138904,540,1450072,20312160
2024-11-20 05:36:21,1858332,60204,1020,183136,13616,980496,354960,933152,317928,47344,37032,520908,345932,1249528,138120,540,1450072,20312088
2024-11-20 05:36:24,1858332,60352,1020,183136,13616,980576,354960,933232,317928,47344,37032,520908,345932,1249456,137968,540,1450072,20311936
2024-11-20 05:36:27,1858332,59900,1020,183136,13616,980644,354960,933300,317928,47344,37032,520908,345932,1249804,137968,540,1450072,20312124
2024-11-20 05:36:29,1858332,60204,1020,183172,13616,980836,354996,933492,317928,47344,37068,520908,345932,1249912,138176,540,1450072,20312068
2024-11-20 05:36:32,1858332,59592,1020,183172,13616,981184,354996,933840,317928,47344,37068,520908,345932,1250172,137972,540,1450072,20312140
2024-11-20 05:36:34,1858332,59620,1020,183172,13620,981424,355000,934080,317932,47344,37068,520908,345932,1250424,138128,540,1450072,20312000
2024-11-20 05:36:37,1858332,59556,1020,183172,13620,981672,355000,934328,317932,47344,37068,520908,345932,1250732,138156,540,1450072,20312116
2024-11-20 05:36:39,1858332,59408,1020,183172,13620,982032,355004,934688,317936,47344,37068,520908,345936,1251032,138176,540,1450072,20312236
2024-11-20 05:36:42,1858332,59104,1020,183172,13620,981876,355004,934532,317936,47344,37068,520908,345936,1251028,138156,540,1450072,20312100
2024-11-20 05:36:44,1858332,58684,1020,183172,13620,982260,355004,934916,317936,47344,37068,520908,345936,1251156,138156,540,1450072,20312156
2024-11-20 05:36:47,1858332,58784,1020,183172,13620,982424,355004,935080,317936,47344,37068,520908,345936,1251572,138156,540,1450072,20312088
2024-11-20 05:36:49,1858332,58764,1020,183172,13620,982388,355004,935044,317936,47344,37068,520908,345936,1251272,137972,540,1450072,20312184
2024-11-20 05:36:52,1858332,58312,1020,183172,13620,982544,355004,935200,317936,47344,37068,520908,345936,1251532,138156,540,1450072,20312036
2024-11-20 05:36:55,1858332,54848,1020,183172,13620,985604,355016,938260,317948,47344,37068,520908,345948,1254668,140600,540,1450072,22233376
2024-11-20 05:36:57,1858332,48272,1028,183172,13628,991616,355236,944212,318220,47404,37016,520908,346212,1261128,144364,540,1450072,24153916
2024-11-20 05:37:00,1858332,37924,1036,183176,13628,1000988,355288,953644,318232,47344,37056,520908,346224,1270708,149588,540,1450072,24155236
2024-11-20 05:37:03,1858332,53680,1044,182720,13540,984260,354432,936316,318464,47944,35968,520908,345880,1253396,139052,544,1450072,20312252
2024-11-20 05:37:05,1858332,53060,1044,182728,13540,984884,354364,936780,318464,48104,35900,520908,345880,1253588,138916,528,1450072,20312052
2024-11-20 05:37:08,1858332,53476,1052,182728,13540,984900,354376,936796,318468,48104,35908,520908,345884,1253528,138712,528,1450072,20312216
2024-11-20 05:37:10,1858332,53280,1052,182728,13540,985164,354376,937060,318468,48104,35908,520908,345884,1253964,138896,528,1450072,20312228
2024-11-20 05:37:12,1858332,53400,1052,182728,13540,985448,354376,937344,318468,48104,35908,520908,345884,1254112,138896,528,1450072,20312076
2024-11-20 05:37:15,1858332,57356,1052,182728,13540,981220,354376,933116,318468,48104,35908,520908,345888,1249924,138164,528,1450072,20311960
2024-11-20 05:37:18,1858332,57644,1052,182728,13540,980808,354376,932704,318468,48104,35908,520908,345892,1249512,138144,528,1450072,20312176
2024-11-20 05:37:20,1858332,57620,1052,182728,13540,981280,354380,933176,318472,48104,35908,520908,345892,1249988,138164,528,1450072,20312096
2024-11-20 05:37:23,1858332,58020,1052,182728,13540,981348,354384,933244,318476,48104,35908,520908,345896,1250112,138144,528,1450072,20312200
2024-11-20 05:37:26,1858332,57492,1052,182728,13540,981776,354384,933672,318476,48104,35908,520908,345896,1250436,138144,528,1450072,20312208
2024-11-20 05:37:28,1858332,57316,1052,182728,13540,982224,354384,934120,318476,48104,35908,520908,345896,1250996,138168,528,1450072,20312064
2024-11-20 05:37:30,1858332,56780,1052,182728,13540,982496,354384,934392,318476,48104,35908,520908,345896,1251400,138144,528,1450072,20312192
2024-11-20 05:37:33,1858332,56436,1052,182728,13540,983024,354384,934920,318476,48104,35908,520908,345896,1252016,137960,528,1450072,20312140
2024-11-20 05:37:35,1858332,55888,1052,182728,13540,983536,354388,935432,318480,48104,35908,520908,345912,1252260,138164,528,1450072,20312076
2024-11-20 05:37:37,1858332,55428,1052,182728,13544,984048,354424,935944,318516,48104,35908,520908,345932,1252796,137960,528,1450072,20312100
2024-11-20 05:37:40,1858332,55024,1052,182728,13544,984020,354424,935916,318516,48104,35908,520908,345932,1252960,138164,528,1450072,20312100
2024-11-20 05:37:43,1858332,55168,1052,182728,13544,983888,354424,935784,318516,48104,35908,520908,345932,1252872,138144,528,1450072,20312272
2024-11-20 05:37:45,1858332,54688,1052,182728,13544,984284,354424,936180,318516,48104,35908,520908,345932,1252992,138004,528,1450072,20312148
2024-11-20 05:37:48,1858332,54520,1052,182728,13544,984408,354424,936304,318516,48104,35908,520908,345932,1253200,138144,528,1450072,20312260
2024-11-20 05:37:51,1858332,54444,1052,182728,13544,984664,354424,936560,318516,48104,35908,520908,345932,1253380,138144,528,1450072,20312192
2024-11-20 05:37:53,1858332,54032,1052,182728,13544,984756,354424,936652,318516,48104,35908,520908,345936,1253616,138120,528,1450072,20312096
2024-11-20 05:37:56,1858332,53756,1052,182728,13544,984976,354424,936872,318516,48104,35908,520908,345936,1254048,138144,528,1450072,20312164
2024-11-20 05:37:58,1858332,53544,1052,182728,13544,985248,354424,937144,318516,48104,35908,520908,345936,1254128,138144,528,1450072,20312132
2024-11-20 05:38:01,1858332,53508,1052,182728,13544,985476,354424,937372,318516,48104,35908,520908,345936,1254328,137960,528,1450072,20312220
2024-11-20 05:38:04,1858332,53448,1052,182728,13544,985744,354424,937640,318516,48104,35908,520908,345936,1254632,138144,528,1450072,20312172
2024-11-20 05:38:06,1858332,53256,1052,182728,13544,985784,354424,937680,318516,48104,35908,520908,345936,1254500,138144,528,1450072,20312140
2024-11-20 05:38:09,1858332,50148,1056,184452,13580,986580,356308,938472,318676,48108,37632,520908,346060,1255736,138276,528,1450072,20312036
2024-11-20 05:38:11,1858332,49916,1056,184452,13580,987144,356308,939036,318676,48108,37632,520908,346060,1256200,138292,528,1450072,20311960
2024-11-20 05:38:14,1858332,53784,1056,185932,13576,981704,357792,933596,318680,48108,39112,520908,346076,1250632,138324,528,1450072,20312140
2024-11-20 05:38:17,1858332,53720,1056,185932,13576,981668,357792,933560,318680,48108,39112,520908,346076,1250656,138308,528,1450072,20312212
2024-11-20 05:38:19,1858332,53448,1056,185932,13576,981572,357792,933464,318680,48108,39112,520908,346076,1250608,138176,528,1450072,20312248
2024-11-20 05:38:22,1858332,53672,1056,185932,13576,981968,357792,933860,318680,48108,39112,520908,346076,1250976,138308,528,1450072,20312212
2024-11-20 05:38:24,1858332,53104,1056,185932,13576,982196,357792,934088,318680,48108,39112,520908,346076,1251316,138324,528,1450072,20312256
2024-11-20 05:38:26,1858332,53016,1056,185932,13576,982280,357792,934172,318680,48108,39112,520908,346076,1251156,138308,528,1450072,20312068
2024-11-20 05:38:29,1858332,52792,1056,185932,13576,982556,357792,934448,318680,48108,39112,520908,346076,1251564,138308,528,1450072,20312116
2024-11-20 05:38:31,1858332,52272,1056,186168,13576,982724,358024,934616,318688,48108,39336,520908,346084,1251708,138340,528,1450072,20312204
2024-11-20 05:38:34,1858332,51976,1056,186168,13576,982772,358036,934664,318688,48108,39348,520908,346084,1251728,138320,528,1450072,20312240
2024-11-20 05:38:37,1858332,51960,1056,186168,13576,982868,358036,934760,318688,48108,39348,520908,346084,1251944,138136,528,1450072,20312240
2024-11-20 05:38:39,1858332,52220,1056,186168,13576,983308,358036,935200,318688,48108,39348,520908,346084,1252120,138348,528,1450072,20312124
2024-11-20 05:38:42,1858332,51644,1056,186168,13576,983308,358036,935200,318688,48108,39348,520908,346084,1252284,138320,528,1450072,20312052
2024-11-20 05:38:44,1858332,51352,1056,186168,13576,983928,358036,935820,318688,48108,39348,520908,346084,1252956,138260,528,1450072,20312132
2024-11-20 05:38:47,1858332,51216,1056,186168,13576,984064,358036,935956,318688,48108,39348,520908,346084,1252984,138260,528,1450072,20311920
2024-11-20 05:38:50,1858332,50756,1056,186168,13576,984120,358036,936012,318688,48108,39348,520908,346084,1253260,138320,528,1450072,20312160
2024-11-20 05:38:52,1858332,50188,1056,186168,13576,984808,358036,936700,318688,48108,39348,520908,346084,1253604,138224,528,1450072,20312104
2024-11-20 05:38:55,1858332,50096,1056,186168,13576,984972,358036,936864,318688,48108,39348,520908,346084,1253968,138136,528,1450072,20312092
2024-11-20 05:38:57,1858332,50040,1056,186168,13576,985016,358036,936908,318688,48108,39348,520908,346084,1254116,138304,528,1450072,20312160
2024-11-20 05:39:00,1858332,49692,1056,186168,13576,985068,358036,936960,318688,48108,39348,520908,346084,1254228,138140,528,1450072,20312200
2024-11-20 05:39:02,1858332,49752,1056,186168,13576,985444,358036,937336,318688,48108,39348,520908,346084,1254428,138344,528,1450072,20312300
2024-11-20 05:39:04,1858332,49312,1056,186168,13576,985628,358036,937520,318688,48108,39348,520908,346084,1254644,138140,528,1450072,20312192
2024-11-20 05:39:07,1858332,49332,1056,186168,13576,985660,358036,937552,318688,48108,39348,520908,346084,1254676,138324,528,1450072,20312112
2024-11-20 05:39:10,1858332,48676,1056,186168,13576,986568,358036,938460,318688,48108,39348,520908,346084,1255424,138324,528,1450072,20312188
2024-11-20 05:39:12,1858332,48720,1056,186168,13576,986544,358036,938436,318688,48108,39348,520908,346084,1255508,138332,528,1450072,20312036
2024-11-20 05:39:15,1858332,48652,1056,186168,13576,986272,358036,938164,318688,48108,39348,520908,346084,1255520,138140,528,1450072,20312208
2024-11-20 05:39:17,1858332,48288,1056,186168,13576,986728,358036,938620,318688,48108,39348,520908,346084,1255660,138192,528,1450072,20312116
2024-11-20 05:39:20,1858332,47932,1056,186168,13576,987292,358036,939184,318688,48108,39348,520908,346084,1256164,138324,528,1450072,20312204
2024-11-20 05:39:22,1858332,49640,1056,186168,13576,985240,357912,937008,318688,48232,39224,520908,346088,1254100,138004,528,1450072,20308612
2024-11-20 05:39:25,1858332,48260,1056,186240,13576,987452,357856,939092,318688,48360,39168,520908,346088,1256080,138244,528,1450072,20312196
2024-11-20 05:39:27,1858332,47880,1056,186240,13576,987788,357856,939428,318688,48360,39168,520908,346088,1256372,138324,528,1450072,20312144
2024-11-20 05:39:30,1858332,47448,1056,186240,13576,988064,357856,939704,318688,48360,39168,520908,346088,1256816,138140,528,1450072,20312300
2024-11-20 05:39:32,1858332,47392,1056,186240,13576,987944,357856,939584,318688,48360,39168,520908,346088,1256820,138324,528,1450072,20312308
2024-11-20 05:39:35,1858332,47192,1056,186240,13576,988252,357856,939892,318688,48360,39168,520908,346088,1256860,138328,528,1450072,20312244
2024-11-20 05:39:37,1858332,47276,1056,186240,13576,988080,357856,939720,318688,48360,39168,520908,346088,1256888,138324,528,1450072,20312064
2024-11-20 05:39:40,1858332,46260,1056,186240,13576,989160,357864,940800,318696,48360,39168,520908,346096,1257860,138380,528,1450072,20312076
2024-11-20 05:39:42,1858332,53528,1056,186240,13576,981668,357864,933308,318696,48360,39168,520908,346108,1250328,138324,528,1450072,20303908
2024-11-20 05:39:45,1858332,53432,1056,186240,13576,981804,357864,933444,318696,48360,39168,520908,346108,1250560,138324,528,1450072,20312060
2024-11-20 05:39:48,1858332,53072,1056,186240,13576,981976,357864,933616,318696,48360,39168,520908,346108,1250756,138140,528,1450072,20312104
2024-11-20 05:39:50,1858332,52676,1056,186240,13576,982188,357864,933828,318696,48360,39168,520908,346108,1251064,138340,528,1450072,20312148
2024-11-20 05:39:53,1858332,52176,1056,186240,13576,982532,357864,934172,318696,48360,39168,520908,346108,1251120,138324,528,1450072,20312208
2024-11-20 05:39:55,1858332,52364,1056,186240,13576,982996,357864,934636,318696,48360,39168,520908,346116,1251816,138328,528,1450072,20312080
2024-11-20 05:39:58,1858332,52224,1056,186240,13576,983100,357872,934740,318704,48360,39168,520908,346116,1251776,138324,528,1450072,20312152
2024-11-20 05:40:00,1858332,43500,1056,193896,13688,983976,365752,935616,318936,48360,46816,520908,346236,1252692,138568,528,1450072,20312140
2024-11-20 05:40:03,1858332,43132,1056,193896,13688,983880,365760,935520,318936,48360,46824,520908,346236,1252876,138752,528,1450072,20312000
2024-11-20 05:40:05,1858332,42724,1056,193896,13688,984696,365760,936336,318936,48360,46824,520908,346236,1253616,138620,528,1450072,20312152
2024-11-20 05:40:08,1858332,42556,1056,193896,13688,984752,365760,936392,318936,48360,46824,520908,346236,1253564,138568,528,1450072,20312196
2024-11-20 05:40:10,1858332,42272,1056,193896,13688,985132,365760,936772,318936,48360,46824,520908,346236,1254296,138568,528,1450072,20312288
2024-11-20 05:40:13,1858332,41796,1056,193896,13688,985884,365760,937524,318936,48360,46824,520908,346236,1254828,138772,528,1450072,20312248
2024-11-20 05:40:16,1858332,41792,1056,193896,13688,985944,365760,937584,318936,48360,46824,520908,346236,1254828,138752,528,1450072,20312132
2024-11-20 05:40:18,1858332,41508,1056,193896,13688,986052,365764,937692,318940,48360,46824,520908,346240,1255000,138804,528,1450072,20312128
2024-11-20 05:40:21,1858332,40936,1056,193896,13688,986404,365768,938044,318944,48360,46824,520908,346244,1255336,138680,528,1450072,20312024
2024-11-20 05:40:23,1858332,40648,1056,193896,13688,986960,365768,938600,318944,48360,46824,520908,346244,1255996,138752,528,1450072,20311928
2024-11-20 05:40:26,1858332,40528,1056,193896,13688,986944,365768,938584,318944,48360,46824,520908,346244,1255884,138772,528,1450072,20312188
2024-11-20 05:40:29,1858332,40416,1056,193896,13688,987568,365768,939208,318944,48360,46824,520908,346244,1256476,138752,528,1450072,20311996
2024-11-20 05:40:31,1858332,39660,1056,193896,13688,987680,365768,939320,318944,48360,46824,520908,346244,1256548,138620,528,1450072,20312052
2024-11-20 05:40:34,1858332,39608,1056,193896,13688,988240,365768,939880,318944,48360,46824,520908,346244,1257196,138692,528,1450072,20312160
2024-11-20 05:40:37,1858332,46472,1056,193896,13688,981220,365768,932860,318944,48360,46824,520908,346244,1250224,138568,528,1450072,20312172
2024-11-20 05:40:40,1858332,46088,1056,193896,13688,981284,365768,932924,318944,48360,46824,520908,346244,1250352,138752,528,1450072,20311980
2024-11-20 05:40:42,1858332,45804,1056,193896,13688,981456,365768,933096,318944,48360,46824,520908,346244,1250412,138772,528,1450072,20312056
2024-11-20 05:40:45,1858332,45664,1056,193896,13688,981844,365768,933484,318944,48360,46824,520908,346244,1250740,138752,528,1450072,20312224
2024-11-20 05:40:47,1858332,45164,1056,193896,13688,981944,365768,933584,318944,48360,46824,520908,346244,1250816,138752,528,1450072,20312196
2024-11-20 05:40:50,1858332,44808,1056,193896,13688,982520,365768,934160,318944,48360,46824,520908,346244,1251308,138772,528,1450072,20312296
2024-11-20 05:40:53,1858332,44008,1056,193896,13688,983412,365768,935052,318944,48360,46824,520908,346244,1252480,138568,528,1450072,20312064
2024-11-20 05:40:55,1858332,43776,1056,193896,13688,983440,365768,935080,318944,48360,46824,520908,346244,1252360,138804,528,1450072,20312172
2024-11-20 05:40:58,1858332,43716,1056,193896,13688,983620,365768,935260,318944,48360,46824,520908,346244,1252700,138752,528,1450072,20312260
2024-11-20 05:41:00,1858332,42908,1056,193896,13688,984080,365768,935720,318944,48360,46824,520908,346244,1252992,138804,528,1450072,20312300
2024-11-20 05:41:03,1858332,42632,1056,193896,13688,984212,365768,935852,318944,48360,46824,520908,346244,1253208,138752,528,1450072,20312048
2024-11-20 05:41:05,1858332,42584,1056,193896,13688,984648,365768,936288,318944,48360,46824,520908,346244,1253512,138568,528,1450072,20312072
2024-11-20 05:41:08,1858332,42428,1056,193896,13688,984732,365768,936372,318944,48360,46824,520908,346244,1253788,138752,528,1450072,20312164
2024-11-20 05:41:10,1858332,41888,1056,193896,13688,984996,365768,936636,318944,48360,46824,520908,346244,1253936,138568,528,1450072,20312284
2024-11-20 05:41:13,1858332,41952,1056,193896,13688,985056,365768,936696,318944,48360,46824,520908,346244,1254036,138616,528,1450072,20312284
2024-11-20 05:41:16,1858332,41948,1056,193896,13688,985268,365768,936908,318944,48360,46824,520908,346244,1254108,138568,528,1450072,20312228
2024-11-20 05:41:18,1858332,41832,1056,193896,13688,985548,365768,937188,318944,48360,46824,520908,346244,1254616,138696,528,1450072,20312208
2024-11-20 05:41:21,1858332,37188,1064,193888,13688,989264,365772,940904,318948,48360,46824,520908,346304,1258724,142944,528,1450072,22233432
2024-11-20 05:41:23,1858332,32916,1064,192636,13596,995328,364796,948252,317932,47076,46864,520908,345676,1265048,147088,520,1450072,24146064
2024-11-20 05:41:26,1858332,42912,972,190496,13596,992732,361760,945220,317564,47512,44196,520908,344908,1261408,144684,520,1450072,22233264
2024-11-20 05:41:29,1858332,42464,1072,190500,13596,993036,361860,945512,317572,47524,44288,520908,344916,1261564,144764,520,1450072,22233300
2024-11-20 05:41:31,1858332,41864,1072,191564,13596,992764,362924,945240,317572,47524,45352,520908,344916,1261540,144976,520,1450072,22233260
2024-11-20 05:41:34,1858332,41864,1080,191564,13596,992748,362932,945224,317572,47524,45360,520908,344916,1261332,144964,520,1450072,22233184
2024-11-20 05:41:37,1858332,41100,1080,191564,13596,993460,362932,945936,317572,47524,45360,520908,344916,1262232,144952,520,1450072,22233224
2024-11-20 05:41:39,1858332,47020,1080,191564,13596,987680,362932,940156,317572,47524,45360,520908,344916,1256352,144260,520,1450072,22233188
2024-11-20 05:41:42,1858332,46784,1080,191564,13596,987396,362932,939872,317572,47524,45360,520908,344916,1256244,144200,520,1450072,22233220
2024-11-20 05:41:44,1858332,47184,1080,191564,13596,987312,362932,939788,317572,47524,45360,520908,344916,1256136,144204,520,1450072,22233036
2024-11-20 05:41:47,1858332,46728,1080,191564,13588,987948,362952,940424,317592,47524,45360,520908,344948,1256588,144220,520,1450072,22233120
2024-11-20 05:41:50,1858332,46796,1080,191564,13588,987776,362952,940252,317592,47524,45360,520908,344948,1256632,144200,520,1450072,22233156
2024-11-20 05:41:52,1858332,46292,1080,191564,13588,988356,362952,940832,317592,47524,45360,520908,344948,1257220,144252,520,1450072,22233180
2024-11-20 05:41:55,1858332,46356,1080,191564,13588,988680,362952,941156,317592,47524,45360,520908,344948,1257164,144016,520,1450072,22233316
2024-11-20 05:41:57,1858332,45940,1080,191564,13588,988812,362952,941288,317592,47524,45360,520908,344996,1257592,144204,520,1450072,22233276
2024-11-20 05:42:00,1858332,45736,1080,191564,13588,989112,362952,941588,317592,47524,45360,520908,344996,1257716,144136,520,1450072,22233124
2024-11-20 05:42:03,1858332,45764,1080,191564,13588,989036,362952,941512,317592,47524,45360,520908,344996,1257936,144204,520,1450072,22233296
2024-11-20 05:42:05,1858332,45608,1080,191564,13588,989580,362952,942056,317592,47524,45360,520908,345024,1258380,144224,520,1450072,22233224
2024-11-20 05:42:08,1858332,44652,1080,191564,13588,989680,362952,942156,317592,47524,45360,520908,345024,1258560,144020,520,1450072,22233188
2024-11-20 05:42:10,1858332,44952,1080,191564,13588,989996,362952,942472,317592,47524,45360,520908,345024,1258608,144064,520,1450072,22233228
2024-11-20 05:42:13,1858332,44192,1080,191564,13588,990360,362952,942836,317592,47524,45360,520908,345024,1258744,144204,520,1450072,22233284
2024-11-20 05:42:15,1858332,44328,1080,191564,13588,990232,362952,942708,317592,47524,45360,520908,345024,1258928,144408,520,1450072,22233292
2024-11-20 05:42:18,1858332,44012,1080,191564,13588,990304,362952,942780,317592,47524,45360,520908,345024,1259184,144204,520,1450072,22233352
2024-11-20 05:42:21,1858332,43920,1080,191564,13588,990216,362952,942692,317592,47524,45360,520908,345024,1259024,144204,520,1450072,22233244
2024-11-20 05:42:23,1858332,43420,1080,191564,13588,990968,362952,943444,317592,47524,45360,520908,345024,1259568,144224,520,1450072,22233364
2024-11-20 05:42:26,1858332,43892,1080,191564,13588,990800,362952,943276,317592,47524,45360,520908,345024,1259476,144020,520,1450072,22233032
2024-11-20 05:42:29,1858332,43944,1080,191564,13588,991252,362952,943728,317592,47524,45360,520908,345024,1259932,144204,520,1450072,22232956
2024-11-20 05:42:31,1858332,43600,1080,191564,13588,991384,362956,943860,317596,47524,45360,520908,345028,1260060,144224,520,1450072,22233024
2024-11-20 05:42:34,1858332,43036,1080,191564,13588,991532,362956,944008,317596,47524,45360,520908,345028,1260104,144204,520,1450072,22233080
2024-11-20 05:42:36,1858332,42812,1080,191564,13588,991752,362972,944228,317612,47524,45360,520908,345064,1260436,144136,520,1450072,22233100
2024-11-20 05:42:39,1858332,42340,1080,191564,13588,992468,362976,944944,317616,47524,45360,520908,345068,1261360,144204,520,1450072,22233144
2024-11-20 05:42:41,1858332,42192,1080,191564,13588,992848,362976,945324,317616,47524,45360,520908,345068,1261476,144276,520,1450072,22232964
2024-11-20 05:42:44,1858332,41852,1080,191564,13588,993044,362976,945520,317616,47524,45360,520908,345068,1261760,144232,520,1450072,22233108
2024-11-20 05:42:47,1858332,41672,1080,191564,13588,992948,362976,945424,317616,47524,45360,520908,345068,1261972,144204,520,1450072,22233156
2024-11-20 05:42:49,1858332,41184,1080,191564,13588,993212,362976,945688,317616,47524,45360,520908,345068,1261844,144224,520,1450072,22233016
2024-11-20 05:42:52,1858332,40892,1080,191564,13588,993684,362976,946160,317616,47524,45360,520908,345068,1262484,144020,520,1450072,22232848
2024-11-20 05:42:54,1858332,40240,1080,191564,13588,994196,362976,946672,317616,47524,45360,520908,345068,1262960,144196,520,1450072,22233044
2024-11-20 05:42:57,1858332,46424,1080,191564,13588,987532,362976,940008,317616,47524,45360,520908,345172,1256128,144204,520,1450072,22232992
2024-11-20 05:42:59,1858332,46564,1080,191564,13588,987516,362980,939992,317620,47524,45360,520908,345172,1256220,144144,520,1450072,22224848
2024-11-20 05:43:01,1858332,46356,1080,191564,13588,987780,362980,940256,317620,47524,45360,520908,345172,1256276,144204,520,1450072,22233008
2024-11-20 05:43:04,1858332,46436,1080,191564,13588,987544,362980,940020,317620,47524,45360,520908,345172,1256196,144224,520,1450072,22232912
2024-11-20 05:43:07,1858332,46112,1080,191564,13588,988048,362980,940524,317620,47524,45360,520908,345172,1257044,144020,520,1450072,22233068
2024-11-20 05:43:09,1858332,45752,1080,191564,13588,988432,362980,940908,317620,47524,45360,520908,345172,1257040,144260,520,1450072,22233008
2024-11-20 05:43:12,1858332,45704,1080,191564,13588,988552,362980,941028,317620,47524,45360,520908,345172,1257288,144220,520,1450072,22233200
2024-11-20 05:43:15,1858332,45892,1080,191564,13588,988336,362980,940812,317620,47524,45360,520908,345172,1257236,144208,520,1450072,22233052
2024-11-20 05:43:17,1858332,45656,1080,191564,13588,988684,362980,941160,317620,47524,45360,520908,345172,1257380,144260,520,1450072,22233140
2024-11-20 05:43:20,1858332,45060,1080,191564,13600,989128,363004,941604,317644,47524,45360,520908,345184,1257788,144208,520,1450072,22233132
2024-11-20 05:43:22,1858332,44648,1080,191564,13600,989240,363004,941716,317644,47524,45360,520908,345184,1257996,144244,520,1450072,22233252
2024-11-20 05:43:24,1858332,44668,1080,191564,13600,989360,363004,941836,317644,47524,45360,520908,345184,1258036,144208,520,1450072,22233244
2024-11-20 05:43:26,1858332,44496,1080,191564,13600,989352,363004,941828,317644,47524,45360,520908,345184,1258124,144208,520,1450072,22232828
2024-11-20 05:43:29,1858332,44248,1080,191564,13600,989756,363004,942232,317644,47524,45360,520908,345184,1258424,144208,520,1450072,22232928
2024-11-20 05:43:31,1858332,43876,1080,191564,13600,990388,363004,942864,317644,47524,45360,520908,345184,1259080,144208,520,1450072,22232952
2024-11-20 05:43:33,1858332,43344,1080,191564,13600,990920,363004,943396,317644,47524,45360,520908,345184,1259772,144208,520,1450072,22232976
2024-11-20 05:43:35,1858332,43052,1080,191564,13600,991196,363004,943672,317644,47524,45360,520908,345184,1260012,144208,520,1450072,22233104
2024-11-20 05:43:37,1858332,42732,1080,191564,13600,991328,363004,943804,317644,47524,45360,520908,345184,1260076,144208,520,1450072,22233192
2024-11-20 05:43:40,1858332,42732,1080,191564,13600,991340,363004,943816,317644,47524,45360,520908,345184,1260136,144208,520,1450072,22233116
2024-11-20 05:43:42,1858332,42728,1080,191564,13600,991644,363004,944120,317644,47524,45360,520908,345184,1260276,144148,520,1450072,22233212
2024-11-20 05:43:44,1858332,42124,1080,191564,13600,991868,363004,944344,317644,47524,45360,520908,345184,1260608,144208,520,1450072,22233176
2024-11-20 05:43:46,1858332,41648,1080,191564,13600,992120,363004,944596,317644,47524,45360,520908,345184,1260904,144208,520,1450072,22233276
2024-11-20 05:43:48,1858332,41608,1080,191564,13600,992140,363004,944616,317644,47524,45360,520908,345184,1260904,144208,520,1450072,22233156
2024-11-20 05:43:50,1858332,41244,1080,191564,13600,993020,363004,945496,317644,47524,45360,520908,345188,1261916,144208,520,1450072,22233104
2024-11-20 05:43:53,1858332,41244,1080,191564,13600,993132,363008,945608,317648,47524,45360,520908,345188,1262104,144024,520,1450072,22233132
2024-11-20 05:43:55,1858332,40904,1080,191564,13600,993560,363012,946036,317652,47524,45360,520908,345192,1262268,144208,520,1450072,22233232
2024-11-20 05:43:57,1858332,47076,1080,191564,13600,987504,363012,939980,317652,47524,45360,520908,345192,1256236,144208,520,1450072,22233224
2024-11-20 05:44:00,1858332,46412,1080,191564,13600,987900,363012,940376,317652,47524,45360,520908,345192,1256340,144024,520,1450072,22233216
2024-11-20 05:44:02,1858332,46296,1080,191564,13600,987860,363012,940336,317652,47524,45360,520908,345192,1256588,144208,520,1450072,22233272
2024-11-20 05:44:04,1858332,46192,1080,191564,13600,987704,363012,940180,317652,47524,45360,520908,345192,1256480,144184,520,1450072,22233072
2024-11-20 05:44:06,1858332,46324,1080,191564,13600,987620,363012,940096,317652,47524,45360,520908,345192,1256364,144208,520,1450072,22232980
2024-11-20 05:44:08,1858332,46044,1080,191564,13600,988128,363016,940604,317656,47524,45360,520908,345196,1256844,144208,520,1450072,22233096
2024-11-20 05:44:11,1858332,45744,1080,191564,13600,988040,363016,940516,317656,47524,45360,520908,345196,1256692,144024,520,1450072,22233008
2024-11-20 05:44:13,1858332,41064,1180,202080,13660,987696,368968,939924,313688,47772,55280,520908,346052,1252532,145128,520,1450072,22097152
2024-11-20 05:44:15,1858332,41344,1180,202772,13620,987128,369816,938952,313800,48176,56016,520908,346216,1251176,142272,520,1450072,22094372
2024-11-20 05:44:17,1858332,40980,1180,202772,13620,987292,369816,939116,313800,48176,56016,520908,346216,1251428,142272,520,1450072,22094392
2024-11-20 05:44:19,1858332,40664,1180,202772,13620,987312,369816,939136,313800,48176,56016,520908,346216,1251440,142272,520,1450072,22094260
2024-11-20 05:44:21,1858332,40596,1180,202772,13620,987504,369816,939328,313800,48176,56016,520908,346216,1251724,142292,520,1450072,22094352
2024-11-20 05:44:23,1858332,40564,1180,202772,13620,987576,369816,939400,313800,48176,56016,520908,346216,1251744,142272,520,1450072,22094236
2024-11-20 05:44:25,1858332,40596,1180,202772,13620,987580,369816,939404,313800,48176,56016,520908,346216,1251692,142272,520,1450072,22094332
2024-11-20 05:44:28,1858332,40504,1180,202772,13620,987888,369816,939712,313800,48176,56016,520908,346216,1251948,142272,520,1450072,22094312
2024-11-20 05:44:30,1858332,40564,1180,202772,13620,987812,369816,939636,313800,48176,56016,520908,346216,1251972,142272,520,1450072,22094236
2024-11-20 05:44:32,1858332,40588,1180,202772,13620,987840,369816,939664,313800,48176,56016,520908,346216,1252028,142272,520,1450072,22094332
2024-11-20 05:44:34,1858332,40628,1180,202784,13616,988368,369828,940192,313800,48176,56028,520908,346220,1252672,142336,520,1450072,22094180
2024-11-20 05:44:36,1858332,39772,1180,202784,13616,988644,369828,940468,313800,48176,56028,520908,346220,1252804,142272,520,1450072,22094324
