Timestamp,MemTotal,MemFree,Buffers,Cached,SwapCached,Active,Inactive,Active(anon),Inactive(anon),Active(file),Inactive(file),SwapTotal,SwapFree,AnonPages,Mapped,Shmem,CommitLimit,Committed_AS
2024-11-20 04:05:50,1858332,142764,2224,1178088,17544,154680,1056404,96904,34204,57776,1022200,520908,364484,129744,433872,712,1450072,24098844
2024-11-20 04:05:50,1858332,142764,2224,1178088,17544,154680,1056404,96904,34204,57776,1022200,520908,364484,129744,433872,712,1450072,24098844
2024-11-20 04:05:50,1858332,142764,2224,1178088,17544,154680,1056404,96904,34204,57776,1022200,520908,364484,129744,433872,712,1450072,24098844
2024-11-20 04:05:50,1858332,142764,2224,1178088,17544,154680,1056404,96904,34204,57776,1022200,520908,364484,129744,433872,712,1450072,24098844
2024-11-20 04:05:50,1858332,142764,2224,1178088,17544,154680,1056404,96904,34204,57776,1022200,520908,364484,129744,433872,712,1450072,24098844
2024-11-20 04:05:50,1858332,142764,2224,1178088,17544,154680,1056404,96904,34204,57776,1022200,520908,364484,129744,433872,712,1450072,24098844
2024-11-20 04:05:50,1858332,142764,2224,1178088,17544,154680,1056404,96904,34204,57776,1022200,520908,364484,129744,433872,712,1450072,24098844
2024-11-20 04:05:50,1858332,142764,2224,1178088,17544,154680,1056404,96904,34204,57776,1022200,520908,364484,129744,433872,712,1450072,24098844
2024-11-20 04:05:50,1858332,142764,2224,1178088,17544,154680,1056404,96904,34204,57776,1022200,520908,364484,129744,433872,712,1450072,24098844
2024-11-20 04:05:50,1858332,142764,2224,1178088,17544,154680,1056404,96904,34204,57776,1022200,520908,364484,129744,433872,712,1450072,24098844
2024-11-20 04:05:50,1858332,142764,2224,1178088,17544,154680,1056404,96904,34204,57776,1022200,520908,364484,129744,433872,712,1450072,24098844
2024-11-20 04:05:52,1858332,140340,988,1183492,17488,646036,577088,104056,34880,541980,542208,520908,364016,137492,799684,712,1450072,24203648
2024-11-20 04:05:55,1858332,138004,992,1186008,17488,646756,579316,104528,34784,542228,544532,520908,364016,137764,823932,712,1450072,24203760
2024-11-20 04:05:57,1858332,138592,992,1185104,17488,647792,577944,104940,35028,542852,542916,520908,363996,138220,852944,712,1450072,24203576
2024-11-20 04:05:59,1858332,140276,960,1185032,17488,647400,577696,104544,34796,542856,542900,520908,363996,137992,873924,712,1450072,24203592
2024-11-20 04:06:01,1858332,138664,964,1186576,17488,648200,578752,104820,34816,543380,543936,520908,363996,138168,901556,712,1450072,24203616
2024-11-20 04:06:03,1858332,143276,152,1190280,17488,642632,580160,97884,34820,544748,545340,520908,363996,131100,905132,712,1450072,24203420
2024-11-20 04:06:05,1858332,142148,156,1190732,17488,643536,580032,98336,34736,545200,545296,520908,363996,131464,899096,712,1450072,24203540
2024-11-20 04:06:08,1858332,141616,164,1191856,17488,642936,582016,98264,34648,544672,547368,520908,363996,131572,893796,712,1450072,24203524
2024-11-20 04:06:10,1858332,142040,156,1190244,17488,643524,580280,98832,34600,544692,545680,520908,363996,131944,891168,712,1450072,24203556
2024-11-20 04:06:12,1858332,142548,164,1189752,17488,643256,579716,98520,34544,544736,545172,520908,363996,131716,888796,712,1450072,24203560
2024-11-20 04:06:14,1858332,142528,164,1190572,17488,642980,580672,98608,34480,544372,546192,520908,363996,131728,884196,712,1450072,24203476
2024-11-20 04:06:16,1858332,142368,164,1189692,17488,643240,579552,98704,34448,544536,545104,520908,363996,131664,881984,712,1450072,24203460
2024-11-20 04:06:19,1858332,142956,160,1189296,17488,643220,579516,99120,34400,544100,545116,520908,363996,131872,879084,712,1450072,24203552
2024-11-20 04:06:21,1858332,142320,164,1188236,17488,643584,578872,99680,34368,543904,544504,520908,363996,132588,880024,712,1450072,24203488
2024-11-20 04:06:23,1858332,134040,652,1187220,17488,652208,578588,108144,35076,544064,543512,520908,364004,141748,875780,712,1450072,24282068
2024-11-20 04:06:25,1858332,100768,652,1185084,17488,684200,580280,141552,37428,542648,542852,520908,364004,177688,875148,712,1450072,24313240
2024-11-20 04:06:27,1858332,33740,636,1106580,16892,748260,585240,244904,81496,503356,503744,520908,364012,326168,820832,712,1450072,25114092
2024-11-20 04:06:30,1858332,32472,128,541548,16444,892808,445052,672160,223912,220648,221140,520908,363888,895900,179052,712,1450072,25113980
2024-11-20 04:06:32,1858332,34144,120,209448,16444,976148,361332,926452,301824,49696,59508,520908,363888,1227828,109752,712,1450072,24100532
2024-11-20 04:06:34,1858332,33552,232,186404,16340,996848,356144,954508,312032,42340,44112,520908,363272,1265888,115020,708,1450072,20274312
2024-11-20 04:06:36,1858332,32088,384,198340,13816,996668,367248,949144,316316,47524,50932,520908,356996,1264580,130296,500,1450072,24115624
2024-11-20 04:06:39,1858332,40044,448,200424,12868,985028,371848,938604,317272,46424,54576,520908,351932,1254244,123584,528,1450072,20373816
2024-11-20 04:06:41,1858332,34552,452,206300,12908,984976,377720,938428,317388,46548,60332,520908,352052,1254468,124036,532,1450072,20274136
2024-11-20 04:06:43,1858332,34496,460,206292,12908,985852,377380,938864,317388,46988,59992,520908,352056,1254776,124036,532,1450072,20274172
2024-11-20 04:06:46,1858332,36768,508,205296,13184,986820,373308,939796,314312,47024,58996,520908,352212,1252364,126832,536,1450072,22194544
2024-11-20 04:06:48,1858332,36860,508,205296,13184,986720,373284,939692,314292,47028,58992,520908,352212,1252320,126656,536,1450072,22194532
2024-11-20 04:06:50,1858332,35540,508,206208,13556,987636,374176,940608,314272,47028,59904,520908,352784,1253348,127068,536,1450072,22194496
2024-11-20 04:06:53,1858332,34396,516,206208,13556,988152,374140,941124,314228,47028,59912,520908,352784,1253868,127252,536,1450072,22194496
2024-11-20 04:06:55,1858332,35024,536,202600,13384,990712,370540,943572,314492,47140,56048,520908,353084,1256424,129332,536,1450072,24115856
2024-11-20 04:06:57,1858332,39892,388,199768,13636,984156,372820,939416,317248,44740,55572,520908,353816,1255092,129352,536,1450072,22194536
2024-11-20 04:06:59,1858332,39176,388,200188,13636,984320,373288,939580,317240,44740,56048,520908,353828,1255248,129360,536,1450072,22194452
2024-11-20 04:07:02,1858332,38244,396,202184,13640,984780,375268,940032,317224,44748,58044,520908,353848,1255784,129440,536,1450072,22194424
2024-11-20 04:07:05,1858332,35124,388,205368,13728,984760,378524,940004,317340,44756,61184,520908,354332,1255776,129920,536,1450072,22194432
2024-11-20 04:07:07,1858332,34860,388,205412,13728,985128,378600,940372,317332,44756,61268,520908,354332,1256208,130004,536,1450072,22194512
2024-11-20 04:07:10,1858332,36208,388,204500,13748,986120,376672,941220,316484,44900,60188,520908,354444,1256168,130108,536,1450072,22194408
2024-11-20 04:07:12,1858332,35976,388,204524,13748,986040,376604,941140,316368,44900,60236,520908,354444,1255704,130064,536,1450072,22194540
2024-11-20 04:07:15,1858332,35620,388,204524,13748,986264,376560,941364,316324,44900,60236,520908,354444,1256244,130116,536,1450072,22194468
2024-11-20 04:07:17,1858332,35112,388,204792,13748,986472,376828,941572,316324,44900,60504,520908,354444,1256484,130204,536,1450072,22194520
2024-11-20 04:07:20,1858332,34464,388,205312,13780,986460,377420,941560,316296,44900,61124,520908,354452,1256412,130168,536,1450072,22194372
2024-11-20 04:07:23,1858332,33736,388,205908,13780,986900,377916,942000,316336,44900,61580,520908,354452,1256888,130232,536,1450072,22194420
2024-11-20 04:07:25,1858332,35772,388,204068,13780,986912,376152,942012,316336,44900,59816,520908,354448,1256816,130232,536,1450072,22194276
2024-11-20 04:07:28,1858332,36660,360,202348,13920,988080,374048,942932,316220,45148,57828,520908,354576,1257732,131468,536,1450072,22194568
2024-11-20 04:07:30,1858332,36428,360,202436,13920,988152,373844,942904,316072,45248,57772,520908,354580,1257444,131572,536,1450072,22194380
2024-11-20 04:07:33,1858332,36324,360,202436,13920,988620,373844,943372,316072,45248,57772,520908,354580,1257728,131316,536,1450072,22194480
2024-11-20 04:07:36,1858332,34728,404,202732,13928,990564,372844,945308,315072,45256,57772,520908,354720,1258612,132416,544,1450072,22194564
2024-11-20 04:07:38,1858332,35540,404,201196,13932,991032,371800,945712,315320,45320,56480,520908,354736,1259632,132800,544,1450072,22194548
2024-11-20 04:07:41,1858332,35344,404,201336,13932,991292,371912,945968,315292,45324,56620,520908,354736,1259732,132876,544,1450072,22194512
2024-11-20 04:07:43,1858332,35308,404,201332,13936,991404,371908,946080,315276,45324,56632,520908,354748,1259664,133060,544,1450072,22194412
2024-11-20 04:07:46,1858332,34964,404,201336,13936,991808,371920,946484,315288,45324,56632,520908,354748,1260196,133092,544,1450072,22194480
2024-11-20 04:07:49,1858332,34484,404,201336,13936,991968,371920,946644,315288,45324,56632,520908,354748,1260452,133068,544,1450072,22194396
2024-11-20 04:07:51,1858332,33000,404,202556,13936,992240,373076,946916,315288,45324,57788,520908,354748,1260816,133248,544,1450072,22194416
2024-11-20 04:07:54,1858332,38184,404,202892,13932,986472,373224,941148,315036,45324,58188,520908,354764,1254604,132496,544,1450072,22194336
2024-11-20 04:07:57,1858332,38360,404,202892,13928,986504,373232,941180,315044,45324,58188,520908,354776,1254596,132476,544,1450072,22194408
2024-11-20 04:07:59,1858332,38356,404,202892,13928,986392,373232,941068,315044,45324,58188,520908,354776,1254592,132480,544,1450072,22194324
2024-11-20 04:08:02,1858332,36356,404,202944,13920,988256,373244,942932,315056,45324,58188,520908,354796,1256488,132484,544,1450072,24114436
2024-11-20 04:08:05,1858332,33480,392,197856,13916,993612,368656,948008,315936,45604,52720,520908,355156,1262452,136300,544,1450072,26035796
2024-11-20 04:08:07,1858332,35316,424,197120,13924,991264,369176,945620,317272,45644,51904,520908,355120,1261456,137040,544,1450072,24115648
2024-11-20 04:08:10,1858332,40480,424,198020,13924,987080,369932,941308,317044,45772,52888,520908,355156,1256620,133028,544,1450072,22194556
2024-11-20 04:08:12,1858332,40288,424,198020,13924,987204,369936,941432,317048,45772,52888,520908,355156,1257028,132844,544,1450072,22194688
2024-11-20 04:08:15,1858332,40200,432,198020,13924,988008,369924,942236,317028,45772,52896,520908,355156,1257656,132972,544,1450072,22194456
2024-11-20 04:08:17,1858332,42416,432,198020,13924,985396,369924,939624,317028,45772,52896,520908,355156,1255132,132276,544,1450072,22194560
2024-11-20 04:08:20,1858332,37540,432,202980,13948,985488,374896,939716,317040,45772,57856,520908,355288,1255180,132392,544,1450072,22194672
2024-11-20 04:08:23,1858332,36412,432,204268,13948,985644,375516,939872,316420,45772,59096,520908,355288,1254844,132736,544,1450072,22202572
2024-11-20 04:08:25,1858332,37616,432,202616,13948,986480,373388,940500,316104,45980,57284,520908,355256,1254984,132700,544,1450072,22202748
2024-11-20 04:08:28,1858332,35408,432,205084,13948,986724,375860,940744,316108,45980,59752,520908,355260,1255108,132792,544,1450072,22202556
2024-11-20 04:08:31,1858332,35636,432,205188,13948,986744,375964,940764,316108,45980,59856,520908,355260,1255420,132772,544,1450072,22202768
2024-11-20 04:08:33,1858332,37752,432,201944,13964,987416,372200,941108,315916,46308,56284,520908,355260,1255412,132788,544,1450072,22202616
2024-11-20 04:08:36,1858332,38216,432,201944,13964,987452,372200,941144,315916,46308,56284,520908,355260,1255652,132604,544,1450072,22202688
2024-11-20 04:08:38,1858332,37572,432,201944,13964,987860,372188,941544,315912,46316,56276,520908,355260,1255972,132808,544,1450072,22202616
2024-11-20 04:08:41,1858332,37756,432,201944,13964,988308,372188,941992,315912,46316,56276,520908,355260,1256440,132788,544,1450072,22202728
2024-11-20 04:08:43,1858332,36984,432,202524,13964,988360,372692,942044,315836,46316,56856,520908,355260,1256312,132848,544,1450072,22202728
2024-11-20 04:08:46,1858332,36892,432,202524,13964,988352,372672,942036,315816,46316,56856,520908,355260,1256192,132800,544,1450072,22202816
2024-11-20 04:08:48,1858332,36804,432,202524,13964,988376,372672,942060,315816,46316,56856,520908,355260,1256460,132800,544,1450072,22202688
2024-11-20 04:08:51,1858332,36300,432,202524,13964,988712,372672,942396,315816,46316,56856,520908,355260,1256844,132800,544,1450072,22202608
2024-11-20 04:08:53,1858332,36276,432,202524,13964,988860,372672,942544,315816,46316,56856,520908,355260,1256656,132616,544,1450072,22202776
2024-11-20 04:08:56,1858332,36184,432,202524,13964,989412,372672,943096,315816,46316,56856,520908,355268,1257272,132748,544,1450072,22202724
2024-11-20 04:08:58,1858332,36092,432,202524,13964,989152,372672,942836,315816,46316,56856,520908,355268,1257112,132804,544,1450072,22202836
2024-11-20 04:09:01,1858332,35372,432,202524,13964,989620,372672,943304,315816,46316,56856,520908,355268,1257572,132744,544,1450072,22202860
2024-11-20 04:09:03,1858332,35224,432,202616,13964,989772,372728,943456,315816,46316,56912,520908,355268,1257668,132808,544,1450072,22202700
2024-11-20 04:09:06,1858332,34944,432,202616,13964,990180,372764,943864,315816,46316,56948,520908,355312,1258060,132832,544,1450072,22202724
2024-11-20 04:09:08,1858332,34896,432,202616,13964,990064,372768,943748,315820,46316,56948,520908,355336,1257896,132624,544,1450072,22202680
2024-11-20 04:09:11,1858332,34312,432,202616,13960,990668,372768,944352,315820,46316,56948,520908,355340,1258580,132752,544,1450072,22202772
2024-11-20 04:09:14,1858332,33900,432,202616,13960,990804,372768,944488,315820,46316,56948,520908,355340,1258792,132808,544,1450072,22202612
2024-11-20 04:09:16,1858332,36536,404,199700,13960,991788,369156,945100,315548,46688,53608,520908,355368,1258996,132792,544,1450072,22202836
2024-11-20 04:09:19,1858332,36608,404,199760,13960,991948,369056,945156,315468,46792,53588,520908,355416,1259012,132808,544,1450072,22202624
2024-11-20 04:09:21,1858332,34668,392,193868,13956,998164,364764,951352,317060,46812,47704,520908,355404,1266592,132868,544,1450072,22202676
2024-11-20 04:09:24,1858332,34436,392,193808,13956,998064,364640,951252,317036,46812,47604,520908,355404,1266676,132632,544,1450072,22202696
2024-11-20 04:09:27,1858332,34124,392,193808,13956,998520,364640,951708,317036,46812,47604,520908,355404,1267164,132816,544,1450072,22202704
2024-11-20 04:09:29,1858332,34620,392,193808,13956,998352,364636,951540,317032,46812,47604,520908,355404,1266912,132812,544,1450072,22202652
2024-11-20 04:09:32,1858332,34300,392,193808,13956,998596,364636,951784,317032,46812,47604,520908,355404,1267196,132632,544,1450072,22202628
2024-11-20 04:09:34,1858332,34416,392,193808,13956,998516,364636,951704,317032,46812,47604,520908,355404,1267432,132816,544,1450072,22202620
2024-11-20 04:09:37,1858332,34052,392,193916,13956,998940,364744,952128,317032,46812,47712,520908,355404,1267712,132820,544,1450072,22202640
2024-11-20 04:09:39,1858332,33864,392,193916,13956,998964,364744,952152,317032,46812,47712,520908,355404,1267668,132820,544,1450072,22202736
2024-11-20 04:09:42,1858332,34536,392,192812,13956,998628,364140,951944,317432,46684,46708,520908,355396,1267812,132760,544,1450072,22202520
2024-11-20 04:09:45,1858332,40552,392,192876,13956,992364,364236,945680,317436,46684,46800,520908,355400,1261620,132644,544,1450072,22202688
2024-11-20 04:09:47,1858332,40472,392,192908,13956,992828,364272,946144,317440,46684,46832,520908,355404,1261964,132832,544,1450072,22202652
2024-11-20 04:09:50,1858332,40532,392,192908,13956,992624,364272,945940,317440,46684,46832,520908,355404,1261880,132836,544,1450072,22202632
2024-11-20 04:09:53,1858332,40444,392,192908,13956,992964,364272,946280,317440,46684,46832,520908,355404,1262276,132840,544,1450072,22202688
2024-11-20 04:09:55,1858332,40324,392,192908,13956,993180,364272,946496,317440,46684,46832,520908,355404,1262508,132860,544,1450072,22202688
2024-11-20 04:09:58,1858332,36044,392,194884,14004,994124,366024,947440,317284,46684,48740,520908,355372,1263028,133212,544,1450072,22202628
2024-11-20 04:10:00,1858332,35620,380,196568,14004,994516,367416,947712,317188,46804,50228,520908,355372,1263292,133252,544,1450072,22202772
2024-11-20 04:10:03,1858332,37824,380,196568,14004,995256,365208,948452,314848,46804,50360,520908,355372,1261624,133344,544,1450072,22202688
2024-11-20 04:10:06,1858332,37864,380,196568,14004,995452,365208,948648,314848,46804,50360,520908,355372,1261748,133216,544,1450072,22202740
2024-11-20 04:10:08,1858332,37272,380,196568,14004,995872,365208,949068,314848,46804,50360,520908,355372,1262552,133420,544,1450072,22202672
2024-11-20 04:10:11,1858332,36776,380,196568,14004,996348,365208,949544,314848,46804,50360,520908,355372,1262688,133584,544,1450072,22202872
2024-11-20 04:10:13,1858332,36252,380,196568,14004,996448,365208,949644,314848,46804,50360,520908,355372,1262920,133400,544,1450072,22202760
2024-11-20 04:10:16,1858332,35912,380,196568,14004,997020,365204,950216,314844,46804,50360,520908,355372,1263460,133320,544,1450072,22202664
2024-11-20 04:10:19,1858332,35088,380,196568,14004,997344,365212,950540,314852,46804,50360,520908,355424,1263932,133220,544,1450072,22202732
2024-11-20 04:10:21,1858332,34380,380,196568,14004,998024,365216,951220,314856,46804,50360,520908,355424,1264408,133456,544,1450072,22202724
2024-11-20 04:10:24,1858332,34576,380,196652,14004,998336,365240,951532,314812,46804,50428,520908,355424,1264768,133416,544,1450072,22210888
2024-11-20 04:10:26,1858332,33348,380,196324,13996,997756,366716,950880,316788,46876,49928,520908,355388,1266040,133732,544,1450072,22212412
2024-11-20 04:10:29,1858332,32772,380,196324,13996,998060,366784,951184,316788,46876,49996,520908,355388,1266364,133780,544,1450072,22212360
2024-11-20 04:10:32,1858332,32960,368,196140,14008,998216,366828,951340,317044,46876,49784,520908,355800,1266840,133732,544,1450072,22212388
2024-11-20 04:10:35,1858332,32164,368,196224,14008,998616,367000,951740,317068,46876,49932,520908,355804,1267180,133872,544,1450072,22212332
2024-11-20 04:10:37,1858332,32164,368,196224,14008,998608,367004,951732,317072,46876,49932,520908,355804,1267036,133896,544,1450072,22212464
2024-11-20 04:10:40,1858332,34540,368,193228,14008,998944,364324,952064,317392,46880,46932,520908,355804,1267920,133704,544,1450072,22212548
2024-11-20 04:10:43,1858332,41180,368,193228,14008,992348,364324,945468,317392,46880,46932,520908,355804,1261592,133808,544,1450072,22212464
2024-11-20 04:10:45,1858332,41164,368,193228,14008,992416,364324,945536,317392,46880,46932,520908,355804,1261224,133808,544,1450072,22212380
2024-11-20 04:10:48,1858332,40976,368,193228,14008,992528,364324,945648,317392,46880,46932,520908,355860,1261416,133832,544,1450072,22212284
2024-11-20 04:10:51,1858332,40880,368,193228,14008,993096,364324,946216,317392,46880,46932,520908,355860,1262144,133808,544,1450072,22212268
2024-11-20 04:10:53,1858332,40892,368,193228,14008,992960,364324,946080,317392,46880,46932,520908,355860,1262108,133808,544,1450072,22212456
2024-11-20 04:10:56,1858332,40544,368,193228,14008,993248,364324,946368,317392,46880,46932,520908,355864,1262320,133624,544,1450072,22212256
2024-11-20 04:10:59,1858332,40512,368,193228,14008,993324,364328,946444,317396,46880,46932,520908,355864,1262392,133808,544,1450072,22212328
2024-11-20 04:11:01,1858332,40408,368,193228,14008,993416,364328,946536,317396,46880,46932,520908,355864,1262584,133828,544,1450072,22212360
2024-11-20 04:11:04,1858332,39988,368,193228,14008,993860,364328,946980,317396,46880,46932,520908,355864,1262768,133860,544,1450072,22212480
2024-11-20 04:11:07,1858332,39728,368,193228,14008,994364,364328,947484,317396,46880,46932,520908,355864,1263232,133624,544,1450072,22212572
2024-11-20 04:11:10,1858332,39900,368,193228,14008,994476,364328,947596,317396,46880,46932,520908,355864,1263360,133808,544,1450072,22212360
2024-11-20 04:11:12,1858332,39260,368,193228,14008,994704,364328,947824,317396,46880,46932,520908,355864,1263580,133832,544,1450072,22212288
2024-11-20 04:11:15,1858332,39204,368,193228,14008,994488,364328,947608,317396,46880,46932,520908,355864,1263432,133624,544,1450072,22212368
2024-11-20 04:11:17,1858332,38832,368,193228,14008,994780,364328,947900,317396,46880,46932,520908,355864,1263660,133624,544,1450072,22212504
2024-11-20 04:11:20,1858332,39124,368,193228,14008,994908,364328,948028,317396,46880,46932,520908,355864,1263944,133828,544,1450072,22212540
2024-11-20 04:11:23,1858332,38600,368,193228,14008,995288,364328,948408,317396,46880,46932,520908,355864,1264148,133832,544,1450072,22212464
2024-11-20 04:11:26,1858332,38348,368,193228,14008,995280,364328,948400,317396,46880,46932,520908,355864,1264244,133808,544,1450072,22212552
2024-11-20 04:11:28,1858332,38672,368,193228,14008,995500,364328,948620,317396,46880,46932,520908,355864,1264500,133644,544,1450072,22212308
2024-11-20 04:11:31,1858332,38480,368,193228,14008,995528,364328,948648,317396,46880,46932,520908,355864,1264652,133624,544,1450072,22212440
2024-11-20 04:11:33,1858332,38112,368,193228,14008,995892,364328,949012,317396,46880,46932,520908,355864,1264904,133808,544,1450072,22212188
2024-11-20 04:11:36,1858332,37968,368,193228,14008,996336,364328,949456,317396,46880,46932,520908,355864,1265224,133832,544,1450072,22212444
2024-11-20 04:11:39,1858332,37680,368,193228,14008,996328,364328,949448,317396,46880,46932,520908,355864,1265288,133808,544,1450072,22212556
2024-11-20 04:11:41,1858332,37196,368,193228,14008,996816,364328,949936,317396,46880,46932,520908,355864,1265728,133652,544,1450072,22212452
2024-11-20 04:11:44,1858332,36884,368,193228,14008,997212,364328,950332,317396,46880,46932,520908,355864,1266020,133752,544,1450072,22212256
2024-11-20 04:11:47,1858332,36908,368,193228,14008,997376,364328,950496,317396,46880,46932,520908,355864,1266392,133808,544,1450072,22212212
2024-11-20 04:11:49,1858332,36996,368,193228,14008,997416,364328,950536,317396,46880,46932,520908,355864,1266224,133588,544,1450072,22212244
2024-11-20 04:11:52,1858332,36616,368,193228,14008,997632,364328,950752,317396,46880,46932,520908,355864,1266692,133832,544,1450072,22212548
2024-11-20 04:11:55,1858332,35992,368,193228,14008,997760,364328,950880,317396,46880,46932,520908,355864,1266716,133624,544,1450072,22204304
2024-11-20 04:11:57,1858332,35680,368,193228,14008,998304,364328,951424,317396,46880,46932,520908,355868,1267076,133856,544,1450072,22212452
2024-11-20 04:12:00,1858332,35876,368,193228,14008,998248,364332,951368,317400,46880,46932,520908,355872,1267256,133816,544,1450072,22204256
2024-11-20 04:12:03,1858332,35292,368,193228,14008,998564,364332,951684,317400,46880,46932,520908,355872,1267528,133816,544,1450072,22212356
2024-11-20 04:12:05,1858332,41468,368,193228,14008,992016,364112,945136,317180,46880,46932,520908,355908,1260700,133820,544,1450072,22212304
2024-11-20 04:12:08,1858332,41740,368,193228,14008,992464,364112,945584,317180,46880,46932,520908,355908,1261136,133816,544,1450072,22212316
2024-11-20 04:12:10,1858332,41816,368,193228,14008,992760,364112,945880,317180,46880,46932,520908,355908,1261436,133816,544,1450072,22212532
2024-11-20 04:12:13,1858332,41452,368,193228,14008,992876,364116,945996,317184,46880,46932,520908,355912,1261492,133816,544,1450072,22212384
2024-11-20 04:12:16,1858332,41176,368,193228,14008,993020,364116,946140,317184,46880,46932,520908,355912,1261680,133632,544,1450072,22212432
2024-11-20 04:12:18,1858332,41088,368,193228,14008,992968,364116,946088,317184,46880,46932,520908,355912,1261744,133836,544,1450072,22212396
2024-11-20 04:12:21,1858332,40556,368,193228,14008,993564,364116,946684,317184,46880,46932,520908,355912,1261976,133816,544,1450072,22204316
2024-11-20 04:12:23,1858332,40564,368,193228,14008,993504,364016,946624,317084,46880,46932,520908,355912,1262032,133632,544,1450072,22212396
2024-11-20 04:12:26,1858332,40504,368,193228,14008,993496,364016,946616,317084,46880,46932,520908,355912,1262012,133812,544,1450072,22212284
2024-11-20 04:12:29,1858332,38428,368,193228,14008,995416,364016,948536,317084,46880,46932,520908,355916,1264052,133816,544,1450072,24132272
2024-11-20 04:12:32,1858332,37740,372,191660,14004,995152,363724,949144,317624,46008,46100,520908,356148,1265360,134692,544,1450072,24224228
2024-11-20 04:12:34,1858332,38572,364,192760,14008,994048,364912,948004,317616,46044,47296,520908,356148,1263956,134560,544,1450072,22212572
2024-11-20 04:12:37,1858332,38228,372,192760,14008,994280,364912,948236,317616,46044,47296,520908,356148,1264152,134376,544,1450072,22212452
2024-11-20 04:12:40,1858332,38132,372,192760,14008,994712,364920,948668,317616,46044,47304,520908,356148,1264732,134744,544,1450072,22212348
2024-11-20 04:12:43,1858332,40936,372,192760,14008,991788,364920,945744,317616,46044,47304,520908,356180,1261816,133640,544,1450072,22212324
2024-11-20 04:12:45,1858332,40748,372,192760,14008,991832,364924,945788,317620,46044,47304,520908,356180,1261804,133860,544,1450072,22212556
2024-11-20 04:12:48,1858332,41476,372,192760,14008,991740,364676,945696,317372,46044,47304,520908,356180,1261308,133832,544,1450072,22212476
2024-11-20 04:12:51,1858332,41616,372,192760,14008,991808,364668,945764,317364,46044,47304,520908,356180,1261512,133752,544,1450072,22212376
2024-11-20 04:12:54,1858332,40840,380,192768,14008,992720,364680,946676,317372,46044,47308,520908,356208,1262728,133840,544,1450072,22212340
2024-11-20 04:12:57,1858332,40036,380,192768,14008,993388,364696,947344,317376,46044,47320,520908,356212,1263140,133840,544,1450072,22212212
2024-11-20 04:12:59,1858332,37908,388,193908,14008,994356,365852,948312,317384,46044,48468,520908,356220,1264248,133844,544,1450072,22204176
2024-11-20 04:13:02,1858332,37328,388,194004,14008,994588,365948,948544,317384,46044,48564,520908,356220,1264472,133860,544,1450072,22212452
2024-11-20 04:13:04,1858332,37252,388,194004,14008,994696,365948,948652,317384,46044,48564,520908,356220,1264356,133860,544,1450072,22212540
2024-11-20 04:13:07,1858332,36756,388,194004,14008,995096,365948,949052,317384,46044,48564,520908,356220,1264904,133884,544,1450072,22212412
2024-11-20 04:13:10,1858332,36648,388,194004,14008,995036,365948,948992,317384,46044,48564,520908,356220,1264920,133860,544,1450072,22212448
2024-11-20 04:13:12,1858332,36356,388,194004,14008,995436,365948,949392,317384,46044,48564,520908,356220,1264980,133720,544,1450072,22212424
2024-11-20 04:13:15,1858332,35976,388,194004,14008,996044,365948,950000,317384,46044,48564,520908,356220,1265640,133756,544,1450072,22204348
2024-11-20 04:13:18,1858332,35660,388,194004,14008,996016,365948,949972,317384,46044,48564,520908,356220,1265728,133860,544,1450072,22212412
2024-11-20 04:13:20,1858332,34824,388,194004,14008,996728,365948,950684,317384,46044,48564,520908,356220,1266400,133676,544,1450072,22204332
2024-11-20 04:13:23,1858332,35036,388,194004,14008,996588,365948,950544,317384,46044,48564,520908,356220,1266492,133884,544,1450072,22212312
2024-11-20 04:13:25,1858332,35456,388,194004,14008,996636,365948,950592,317384,46044,48564,520908,356220,1266456,133860,544,1450072,22212396
2024-11-20 04:13:28,1858332,35392,388,194004,14008,996920,365948,950876,317384,46044,48564,520908,356220,1266688,133868,544,1450072,22212396
2024-11-20 04:13:31,1858332,34776,388,194004,14008,997128,365948,951084,317384,46044,48564,520908,356220,1266780,133860,544,1450072,22212452
2024-11-20 04:13:33,1858332,34744,388,194004,14008,997024,365948,950980,317384,46044,48564,520908,356220,1266680,133880,544,1450072,22212416
2024-11-20 04:13:36,1858332,34736,388,194004,14008,997312,365948,951268,317384,46044,48564,520908,356220,1267132,133676,544,1450072,22204168
2024-11-20 04:13:39,1858332,34524,388,194004,14008,997304,365948,951260,317384,46044,48564,520908,356220,1267004,133860,544,1450072,22212384
2024-11-20 04:13:41,1858332,33712,388,194004,14008,998304,365948,952260,317384,46044,48564,520908,356220,1268120,133728,544,1450072,22204160
2024-11-20 04:13:44,1858332,40436,388,194004,14008,991664,365712,945620,317148,46044,48564,520908,356220,1261284,133676,544,1450072,22212432
2024-11-20 04:13:46,1858332,40160,388,194004,14008,991932,365712,945888,317148,46044,48564,520908,356220,1261356,133860,544,1450072,22212528
2024-11-20 04:13:49,1858332,40124,388,194004,14008,991952,365712,945908,317148,46044,48564,520908,356220,1261312,133860,544,1450072,22212332
2024-11-20 04:13:51,1858332,40184,388,194004,14008,992152,365712,946108,317148,46044,48564,520908,356220,1261756,133860,544,1450072,22204324
2024-11-20 04:13:54,1858332,39780,388,194004,14008,992584,365712,946540,317148,46044,48564,520908,356220,1262152,133868,544,1450072,22212420
2024-11-20 04:13:57,1858332,39672,388,194004,14008,993028,365712,946984,317148,46044,48564,520908,356220,1262480,133860,544,1450072,22204204
2024-11-20 04:13:59,1858332,39344,388,194004,14008,992728,365712,946684,317148,46044,48564,520908,356220,1262184,133912,544,1450072,22212548
2024-11-20 04:14:02,1858332,38520,388,193996,14016,993268,365712,947224,317148,46044,48564,520908,356232,1262748,133860,544,1450072,22212496
2024-11-20 04:14:04,1858332,38624,388,194004,14016,993248,365732,947204,317168,46044,48564,520908,356232,1262652,133908,544,1450072,22212492
2024-11-20 04:14:06,1858332,38404,388,194004,14012,993516,365728,947472,317164,46044,48564,520908,356240,1263056,133860,544,1450072,22212396
2024-11-20 04:14:09,1858332,38164,388,194004,14012,993456,365728,947412,317164,46044,48564,520908,356240,1262884,133860,544,1450072,22212356
2024-11-20 04:14:11,1858332,38092,388,194004,14012,993828,365728,947784,317164,46044,48564,520908,356240,1263324,133860,544,1450072,22212508
2024-11-20 04:14:13,1858332,37716,388,194004,14012,993932,365728,947888,317164,46044,48564,520908,356240,1263396,133860,544,1450072,22212380
2024-11-20 04:14:16,1858332,37452,388,194004,14012,994096,365728,948052,317164,46044,48564,520908,356240,1263600,133860,544,1450072,22212544
2024-11-20 04:14:18,1858332,37468,388,194004,14012,994356,365728,948312,317164,46044,48564,520908,356240,1263852,133860,544,1450072,22212544
2024-11-20 04:14:20,1858332,37344,388,194004,14012,994616,365728,948572,317164,46044,48564,520908,356240,1264124,133860,544,1450072,22212436
2024-11-20 04:14:22,1858332,37372,388,194004,14012,994640,365728,948596,317164,46044,48564,520908,356240,1264124,133860,544,1450072,22212548
2024-11-20 04:14:25,1858332,36988,388,194024,14012,994808,365748,948764,317164,46044,48584,520908,356240,1264264,133904,544,1450072,22212444
2024-11-20 04:14:27,1858332,37124,388,194024,14012,994784,365748,948740,317164,46044,48584,520908,356240,1264200,133864,544,1450072,22212432
2024-11-20 04:14:30,1858332,36796,388,194024,14012,995036,365748,948992,317164,46044,48584,520908,356240,1264472,133864,544,1450072,22212396
2024-11-20 04:14:32,1858332,36456,388,194024,14012,995432,365748,949388,317164,46044,48584,520908,356240,1264916,133864,544,1450072,22212508
2024-11-20 04:14:34,1858332,33680,388,196096,14084,995620,367844,949428,317400,46192,50444,520908,356408,1265220,134304,544,1450072,22212508
2024-11-20 04:14:37,1858332,34100,388,196044,14084,996336,367124,949772,317020,46564,50104,520908,356144,1265184,134388,544,1450072,22212612
2024-11-20 04:14:39,1858332,34100,388,196144,14084,996496,367112,949884,317032,46612,50080,520908,356144,1265300,134412,544,1450072,22212616
2024-11-20 04:14:41,1858332,33812,388,196144,14084,996432,367168,949820,317032,46612,50136,520908,356144,1265172,134412,544,1450072,22212560
2024-11-20 04:14:44,1858332,33560,388,196144,14084,996456,367168,949844,317032,46612,50136,520908,356144,1265356,134228,544,1450072,22212616
2024-11-20 04:14:46,1858332,32912,524,196192,14084,997156,367292,950544,317032,46612,50260,520908,356144,1266048,134412,544,1450072,22212476
2024-11-20 04:14:48,1858332,32748,524,196200,14084,997288,367320,950636,317032,46652,50288,520908,356144,1266048,134424,544,1450072,22212628
2024-11-20 04:14:51,1858332,32488,524,196200,14084,997540,367320,950888,317032,46652,50288,520908,356144,1266324,134424,544,1450072,22212504
2024-11-20 04:14:53,1858332,32644,532,196200,14084,997560,367320,950908,317032,46652,50288,520908,356144,1266320,134424,544,1450072,22212500
2024-11-20 04:14:55,1858332,32460,532,196200,14084,997584,367328,950932,317032,46652,50296,520908,356152,1266380,134424,544,1450072,22212500
2024-11-20 04:14:57,1858332,32248,532,196200,14084,997916,367328,951264,317032,46652,50296,520908,356152,1266660,134424,544,1450072,22212504
2024-11-20 04:15:00,1858332,33332,532,194912,14084,998040,365840,951388,317032,46652,48808,520908,356116,1266844,134424,544,1450072,22212616
2024-11-20 04:15:02,1858332,33228,532,194812,14084,998248,365764,951496,316956,46752,48808,520908,356116,1266812,134424,544,1450072,22212624
2024-11-20 04:15:04,1858332,33068,532,194812,14084,998344,365764,951592,316956,46752,48808,520908,356116,1267048,134424,544,1450072,22212600
2024-11-20 04:15:06,1858332,32724,532,194812,14084,998588,365764,951836,316956,46752,48808,520908,356116,1267320,134424,544,1450072,22212460
2024-11-20 04:15:09,1858332,32564,532,194812,14084,998740,365764,951988,316956,46752,48808,520908,356116,1267324,134424,544,1450072,22212364
2024-11-20 04:15:11,1858332,39116,532,194812,14084,992288,365764,945536,316956,46752,48808,520908,356136,1261060,134392,544,1450072,22212464
2024-11-20 04:15:13,1858332,38780,532,194812,14084,992512,365764,945760,316956,46752,48808,520908,356136,1261120,134424,544,1450072,22212532
2024-11-20 04:15:16,1858332,38268,532,194812,14084,992688,365764,945936,316956,46752,48808,520908,356136,1261328,134448,544,1450072,22212416
2024-11-20 04:15:18,1858332,38544,532,194812,14084,992800,365764,946048,316956,46752,48808,520908,356136,1261340,134424,544,1450072,22212464
2024-11-20 04:15:20,1858332,38760,532,194812,14084,993112,365764,946360,316956,46752,48808,520908,356136,1261768,134424,544,1450072,22212448
2024-11-20 04:15:23,1858332,38152,532,194812,14084,993132,365764,946380,316956,46752,48808,520908,356136,1261904,134392,544,1450072,22212452
2024-11-20 04:15:25,1858332,37912,532,194812,14084,993280,365764,946528,316956,46752,48808,520908,356136,1262164,134424,544,1450072,22212328
2024-11-20 04:15:28,1858332,37992,532,194812,14084,993424,365764,946672,316956,46752,48808,520908,356136,1262084,134488,544,1450072,22212376
2024-11-20 04:15:30,1858332,37736,532,194812,14084,993712,365764,946960,316956,46752,48808,520908,356136,1262240,134240,544,1450072,22212372
2024-11-20 04:15:33,1858332,37276,532,194812,14084,994436,365768,947684,316960,46752,48808,520908,356140,1263096,134424,544,1450072,22212464
2024-11-20 04:15:35,1858332,36772,532,194812,14084,995060,365768,948308,316960,46752,48808,520908,356164,1263868,134424,544,1450072,22212404
2024-11-20 04:15:38,1858332,36768,532,194812,14084,995500,365772,948748,316964,46752,48808,520908,356164,1264112,134424,544,1450072,22212484
2024-11-20 04:15:40,1858332,36112,532,194812,14084,996432,365772,949680,316964,46752,48808,520908,356164,1265252,134476,544,1450072,22212524
2024-11-20 04:15:43,1858332,35800,532,194812,14084,996608,365772,949856,316964,46752,48808,520908,356164,1265380,134240,544,1450072,22212384
2024-11-20 04:15:46,1858332,35652,532,194812,14084,996516,365772,949764,316964,46752,48808,520908,356164,1265456,134424,544,1450072,22212404
2024-11-20 04:15:48,1858332,35320,532,194812,14084,996884,365764,950132,316956,46752,48808,520908,356164,1265628,134424,544,1450072,22212304
2024-11-20 04:15:51,1858332,35128,532,194812,14084,997080,365764,950328,316956,46752,48808,520908,356164,1265656,134440,544,1450072,22212408
2024-11-20 04:15:54,1858332,35036,532,194812,14084,997076,365768,950324,316960,46752,48808,520908,356168,1265792,134240,544,1450072,22212360
2024-11-20 04:15:57,1858332,34920,532,194812,14084,997512,365768,950760,316960,46752,48808,520908,356168,1266280,134428,544,1450072,22212332
2024-11-20 04:15:59,1858332,34424,532,194812,14084,997836,365768,951084,316960,46752,48808,520908,356168,1266456,134476,544,1450072,22212224
2024-11-20 04:16:02,1858332,34356,532,194812,14084,997756,365768,951004,316960,46752,48808,520908,356168,1266632,134484,544,1450072,22212536
2024-11-20 04:16:05,1858332,34640,532,194812,14084,998068,365768,951316,316960,46752,48808,520908,356168,1266704,134608,544,1450072,22212440
2024-11-20 04:16:07,1858332,34548,532,194812,14084,998372,365768,951620,316960,46752,48808,520908,356168,1267196,134424,544,1450072,22212452
2024-11-20 04:16:10,1858332,34212,532,194812,14084,998344,365768,951592,316960,46752,48808,520908,356168,1267136,134328,544,1450072,22212348
2024-11-20 04:16:13,1858332,34212,532,194812,14084,998276,365768,951524,316960,46752,48808,520908,356168,1267060,134424,544,1450072,22212500
2024-11-20 04:16:15,1858332,33452,532,194812,14084,999024,365768,952272,316960,46752,48808,520908,356168,1267756,134240,544,1450072,22212564
2024-11-20 04:16:18,1858332,33372,532,194812,14084,999064,365768,952312,316960,46752,48808,520908,356168,1267648,134368,544,1450072,22212472
2024-11-20 04:16:21,1858332,34560,532,193620,14084,999132,364776,952236,317304,46896,47472,520908,356028,1268144,134428,544,1450072,22212412
2024-11-20 04:16:23,1858332,40624,532,193620,14084,992784,364776,945888,317304,46896,47472,520908,356048,1261676,134428,544,1450072,22212448
2024-11-20 04:16:26,1858332,40524,532,193620,14084,992796,364776,945900,317304,46896,47472,520908,356048,1261784,134452,544,1450072,22212288
2024-11-20 04:16:29,1858332,40692,532,193620,14084,992736,364776,945840,317304,46896,47472,520908,356048,1261640,134428,544,1450072,22212460
2024-11-20 04:16:31,1858332,40240,532,193620,14084,992972,364776,946076,317304,46896,47472,520908,356048,1261772,134480,544,1450072,22212568
2024-11-20 04:16:34,1858332,39760,532,193620,14084,993360,364776,946464,317304,46896,47472,520908,356048,1262228,134244,544,1450072,22212420
2024-11-20 04:16:37,1858332,39948,532,193620,14084,993524,364776,946628,317304,46896,47472,520908,356048,1262412,134428,544,1450072,22212296
2024-11-20 04:16:39,1858332,39556,532,193620,14084,993580,364776,946684,317304,46896,47472,520908,356048,1262588,134428,544,1450072,22212460
2024-11-20 04:16:42,1858332,39300,532,193620,14084,993896,364776,947000,317304,46896,47472,520908,356048,1262672,134304,544,1450072,22212552
2024-11-20 04:16:45,1858332,39516,532,193620,14084,993992,364776,947096,317304,46896,47472,520908,356048,1262860,134244,544,1450072,22212316
2024-11-20 04:16:47,1858332,38368,560,194532,14084,993948,365680,947052,317300,46896,48380,520908,356048,1262932,134428,544,1450072,22212420
2024-11-20 04:16:50,1858332,37868,560,194532,14084,994820,365712,947924,317300,46896,48412,520908,356048,1263764,134452,544,1450072,22212372
2024-11-20 04:16:53,1858332,37784,560,194532,14084,994848,365712,947952,317300,46896,48412,520908,356048,1264164,134428,544,1450072,22212348
2024-11-20 04:16:56,1858332,36964,640,194444,14092,995492,365712,948596,317300,46896,48412,520908,356084,1264344,134612,544,1450072,22212452
2024-11-20 04:16:58,1858332,36760,640,194556,14092,995788,365848,948880,317344,46908,48504,520908,356084,1264752,134524,544,1450072,22212552
2024-11-20 04:17:01,1858332,36092,640,194556,14092,996288,365848,949380,317344,46908,48504,520908,356084,1265084,134500,544,1450072,22212448
2024-11-20 04:17:03,1858332,36148,648,194556,14092,996160,365848,949252,317344,46908,48504,520908,356084,1265020,134500,544,1450072,22204292
2024-11-20 04:17:06,1858332,36176,648,194556,14092,996356,365856,949448,317344,46908,48512,520908,356084,1265260,134392,544,1450072,22212324
2024-11-20 04:17:09,1858332,35744,648,194556,14092,996428,365856,949520,317344,46908,48512,520908,356084,1265344,134500,544,1450072,22204340
2024-11-20 04:17:11,1858332,35588,648,194556,14092,996704,365856,949796,317344,46908,48512,520908,356084,1265716,134552,544,1450072,22212456
2024-11-20 04:17:14,1858332,35400,648,194556,14092,996728,365856,949820,317344,46908,48512,520908,356084,1265644,134316,544,1450072,22204276
2024-11-20 04:17:16,1858332,35108,648,194556,14092,997184,365856,950276,317344,46908,48512,520908,356084,1266052,134552,544,1450072,22212488
2024-11-20 04:17:19,1858332,35372,648,194556,14092,997264,365856,950356,317344,46908,48512,520908,356084,1265996,134500,544,1450072,22212492
2024-11-20 04:17:22,1858332,34844,648,194556,14092,997500,365856,950592,317344,46908,48512,520908,356084,1266380,134500,544,1450072,22212436
2024-11-20 04:17:24,1858332,34148,648,194556,14092,997656,365856,950748,317344,46908,48512,520908,356084,1266448,134500,544,1450072,22212388
2024-11-20 04:17:26,1858332,34068,648,194556,14092,997884,365856,950976,317344,46908,48512,520908,356084,1266704,134500,544,1450072,22212508
2024-11-20 04:17:28,1858332,33728,648,194556,14092,997664,365856,950756,317344,46908,48512,520908,356084,1266524,134500,544,1450072,22212492
2024-11-20 04:17:31,1858332,33952,648,194556,14092,997792,365856,950884,317344,46908,48512,520908,356084,1266548,134316,544,1450072,22212380
2024-11-20 04:17:33,1858332,33152,648,194556,14092,998132,365856,951224,317344,46908,48512,520908,356084,1267196,134316,544,1450072,22212444
2024-11-20 04:17:35,1858332,33236,648,194556,14092,998508,365856,951600,317344,46908,48512,520908,356092,1267456,134500,544,1450072,22212332
2024-11-20 04:17:38,1858332,33364,648,194556,14092,998624,365856,951716,317344,46908,48512,520908,356092,1267484,134448,544,1450072,22212488
2024-11-20 04:17:40,1858332,32900,648,194556,14092,998832,365856,951924,317344,46908,48512,520908,356092,1267872,134504,544,1450072,22212476
2024-11-20 04:17:43,1858332,39556,648,194556,14092,992428,365860,945520,317348,46908,48512,520908,356096,1261236,134508,544,1450072,22212516
2024-11-20 04:17:45,1858332,39080,648,194556,14092,992568,365860,945660,317348,46908,48512,520908,356096,1261396,134508,544,1450072,22212460
2024-11-20 04:17:47,1858332,39064,648,194556,14092,992788,365860,945880,317348,46908,48512,520908,356096,1261612,134508,544,1450072,22212516
2024-11-20 04:17:49,1858332,38724,648,194556,14092,992680,365860,945772,317348,46908,48512,520908,356096,1261612,134508,544,1450072,22212424
2024-11-20 04:17:52,1858332,38648,648,194556,14092,993076,365860,946168,317348,46908,48512,520908,356096,1261952,134532,544,1450072,22212444
2024-11-20 04:17:54,1858332,38528,648,194556,14092,993108,365860,946200,317348,46908,48512,520908,356096,1261916,134508,544,1450072,22212356
2024-11-20 04:17:57,1858332,38120,648,194556,14092,993380,365868,946472,317356,46908,48512,520908,356104,1262352,134508,544,1450072,22212336
2024-11-20 04:17:59,1858332,38036,648,194556,14092,993400,365868,946492,317356,46908,48512,520908,356104,1262164,134508,544,1450072,22212428
2024-11-20 04:18:01,1858332,37492,648,194556,14092,993792,365868,946884,317356,46908,48512,520908,356104,1262480,134508,544,1450072,22212412
2024-11-20 04:18:03,1858332,37392,648,194556,14092,993756,365868,946848,317356,46908,48512,520908,356104,1262548,134508,544,1450072,22212300
2024-11-20 04:18:06,1858332,36968,648,194556,14092,994296,365868,947388,317356,46908,48512,520908,356104,1263180,134508,544,1450072,22212236
2024-11-20 04:18:08,1858332,37156,648,194556,14092,994156,365868,947248,317356,46908,48512,520908,356104,1263252,134508,544,1450072,22212328
2024-11-20 04:18:10,1858332,37060,648,194556,14092,994292,365868,947384,317356,46908,48512,520908,356104,1263072,134508,544,1450072,22212264
2024-11-20 04:18:13,1858332,36800,648,194556,14092,994480,365868,947572,317356,46908,48512,520908,356104,1263428,134528,544,1450072,22212484
2024-11-20 04:18:15,1858332,35980,648,194556,14092,995212,365868,948304,317356,46908,48512,520908,356104,1264140,134508,544,1450072,22212268
2024-11-20 04:18:18,1858332,35500,648,194556,14092,995644,365868,948736,317356,46908,48512,520908,356104,1264532,134508,544,1450072,22212160
2024-11-20 04:18:20,1858332,35304,648,194556,14092,996304,365868,949396,317356,46908,48512,520908,356104,1265340,134508,544,1450072,22212256
2024-11-20 04:18:23,1858332,35180,648,194556,14092,996708,365868,949800,317356,46908,48512,520908,356104,1265620,134532,544,1450072,22212324
2024-11-20 04:18:26,1858332,35244,648,194556,14092,996624,365868,949716,317356,46908,48512,520908,356104,1265400,134324,544,1450072,22212500
2024-11-20 04:18:28,1858332,35004,648,194556,14092,996764,365868,949856,317356,46908,48512,520908,356104,1265492,134424,544,1450072,22212416
2024-11-20 04:18:31,1858332,35376,648,194556,14092,996948,365868,950040,317356,46908,48512,520908,356104,1265764,134324,544,1450072,22204268
2024-11-20 04:18:33,1858332,34788,648,194556,14092,997280,365868,950372,317356,46908,48512,520908,356104,1266276,134508,544,1450072,22212584
2024-11-20 04:18:36,1858332,34384,648,194556,14092,997424,365868,950516,317356,46908,48512,520908,356104,1266276,134532,544,1450072,22212312
2024-11-20 04:18:39,1858332,34308,648,194556,14092,997596,365868,950688,317356,46908,48512,520908,356104,1266348,134508,544,1450072,22212448
2024-11-20 04:18:41,1858332,34248,648,194556,14092,998032,365868,951124,317356,46908,48512,520908,356104,1267012,134560,544,1450072,22204404
2024-11-20 04:18:44,1858332,33908,648,194556,14092,998240,365868,951332,317356,46908,48512,520908,356104,1267304,134508,544,1450072,22212440
2024-11-20 04:18:47,1858332,33552,648,194556,14092,998604,365868,951696,317356,46908,48512,520908,356104,1267420,134508,544,1450072,22204232
2024-11-20 04:18:49,1858332,33104,648,194556,14080,999216,365868,952308,317356,46908,48512,520908,356116,1268272,134536,544,1450072,22212452
2024-11-20 04:18:52,1858332,39712,648,194556,14080,992780,365736,945872,317224,46908,48512,520908,356236,1261564,134488,544,1450072,22204344
2024-11-20 04:18:55,1858332,39796,648,194556,14080,992792,365736,945884,317224,46908,48512,520908,356236,1261628,134516,544,1450072,22212484
2024-11-20 04:18:57,1858332,39596,648,194556,14080,992736,365736,945828,317224,46908,48512,520908,356236,1261424,134516,544,1450072,22204288
2024-11-20 04:19:00,1858332,38964,648,194556,14080,993304,365736,946396,317224,46908,48512,520908,356244,1262324,134332,544,1450072,22212428
2024-11-20 04:19:02,1858332,38800,648,194556,14080,993588,365744,946680,317232,46908,48512,520908,356244,1262340,134516,544,1450072,22204296
2024-11-20 04:19:05,1858332,38404,648,194556,14080,993828,365744,946920,317232,46908,48512,520908,356244,1262544,134540,544,1450072,22212236
2024-11-20 04:19:08,1858332,38248,648,194556,14080,994124,365744,947216,317232,46908,48512,520908,356244,1262956,134332,544,1450072,22204200
2024-11-20 04:19:10,1858332,38296,648,194556,14080,994320,365744,947412,317232,46908,48512,520908,356244,1262992,134512,544,1450072,22212448
2024-11-20 04:19:12,1858332,37996,648,194556,14080,994296,365744,947388,317232,46908,48512,520908,356244,1262984,134516,544,1450072,22212448
2024-11-20 04:19:15,1858332,38128,648,194556,14080,994160,365744,947252,317232,46908,48512,520908,356244,1262828,134516,544,1450072,22212472
2024-11-20 04:19:18,1858332,37744,648,194556,14080,994736,365744,947828,317232,46908,48512,520908,356244,1263480,134332,544,1450072,22204268
2024-11-20 04:19:20,1858332,37408,648,194556,14080,994836,365744,947928,317232,46908,48512,520908,356244,1263508,134332,544,1450072,22212348
2024-11-20 04:19:23,1858332,37172,648,194556,14080,995220,365744,948312,317232,46908,48512,520908,356244,1263960,134516,544,1450072,22212384
2024-11-20 04:19:26,1858332,36696,648,194556,14080,995508,365744,948600,317232,46908,48512,520908,356244,1264296,134332,544,1450072,22212448
2024-11-20 04:19:28,1858332,36452,648,194556,14080,995700,365744,948792,317232,46908,48512,520908,356244,1264612,134516,544,1450072,22212296
2024-11-20 04:19:31,1858332,35996,648,194556,14080,995948,365744,949040,317232,46908,48512,520908,356244,1264924,134516,544,1450072,22212556
2024-11-20 04:19:33,1858332,35556,648,194556,14080,996356,365744,949448,317232,46908,48512,520908,356244,1265000,134516,544,1450072,22212464
2024-11-20 04:19:36,1858332,35948,648,194556,14080,996372,365744,949464,317232,46908,48512,520908,356244,1265188,134516,544,1450072,22212336
2024-11-20 04:19:38,1858332,36032,648,194556,14080,996736,365744,949828,317232,46908,48512,520908,356244,1265440,134332,544,1450072,22204212
2024-11-20 04:19:41,1858332,35832,648,194556,14080,996748,365744,949840,317232,46908,48512,520908,356244,1265440,134332,544,1450072,22212492
2024-11-20 04:19:44,1858332,36020,648,194556,14080,996792,365716,949884,317204,46908,48512,520908,356328,1265520,134332,544,1450072,22212372
2024-11-20 04:19:46,1858332,35740,648,194556,14080,996988,365716,950080,317204,46908,48512,520908,356328,1265672,134640,544,1450072,22212444
2024-11-20 04:19:49,1858332,35056,648,194556,14080,997412,365716,950504,317204,46908,48512,520908,356328,1265856,134516,544,1450072,22212360
2024-11-20 04:19:51,1858332,35020,648,194556,14080,997536,365716,950628,317204,46908,48512,520908,356328,1266240,134520,544,1450072,22212400
2024-11-20 04:19:54,1858332,35228,648,194556,14080,997600,365716,950692,317204,46908,48512,520908,356328,1266368,134484,544,1450072,22212484
2024-11-20 04:19:57,1858332,34960,648,194556,14080,997712,365716,950804,317204,46908,48512,520908,356328,1266544,134524,544,1450072,22212380
2024-11-20 04:19:59,1858332,34364,648,194556,14080,997860,365716,950952,317204,46908,48512,520908,356328,1266736,134536,544,1450072,22212280
2024-11-20 04:20:02,1858332,34148,648,194556,14080,998016,365716,951108,317204,46908,48512,520908,356328,1266668,134544,544,1450072,22212332
2024-11-20 04:20:05,1858332,34348,648,194556,14080,998492,365716,951584,317204,46908,48512,520908,356328,1267128,134524,544,1450072,22212484
2024-11-20 04:20:07,1858332,33256,648,194556,14080,999412,365716,952504,317204,46908,48512,520908,356328,1268076,134584,544,1450072,22212380
2024-11-20 04:20:10,1858332,38868,648,194556,14080,993116,365716,946208,317204,46908,48512,520908,356328,1261828,134548,544,1450072,22204388
2024-11-20 04:20:13,1858332,38796,648,194556,14080,992908,365716,946000,317204,46908,48512,520908,356328,1261636,134524,544,1450072,22212528
2024-11-20 04:20:15,1858332,38656,648,194556,14080,993124,365716,946216,317204,46908,48512,520908,356328,1261756,134392,544,1450072,22204288
2024-11-20 04:20:18,1858332,39016,648,194556,14080,993044,365716,946136,317204,46908,48512,520908,356328,1261800,134524,544,1450072,22212328
2024-11-20 04:20:20,1858332,39008,648,194556,14080,993664,365716,946756,317204,46908,48512,520908,356328,1262476,134524,544,1450072,22212400
2024-11-20 04:20:23,1858332,38388,648,194556,14080,993656,365716,946748,317204,46908,48512,520908,356328,1262316,134340,544,1450072,22212412
2024-11-20 04:20:25,1858332,38460,648,194556,14080,993968,365716,947060,317204,46908,48512,520908,356328,1262888,134524,544,1450072,22212412
2024-11-20 04:20:28,1858332,37668,648,194556,14080,994332,365716,947424,317204,46908,48512,520908,356328,1263224,134544,544,1450072,22212476
2024-11-20 04:20:31,1858332,37992,648,194556,14080,994388,365716,947480,317204,46908,48512,520908,356328,1263164,134524,544,1450072,22212400
2024-11-20 04:20:33,1858332,38004,648,194556,14080,994260,365716,947352,317204,46908,48512,520908,356328,1263196,134524,544,1450072,22212252
2024-11-20 04:20:36,1858332,37728,648,194556,14080,994656,365716,947748,317204,46908,48512,520908,356328,1263460,134524,544,1450072,22212332
2024-11-20 04:20:38,1858332,37644,648,194556,14080,994884,365716,947976,317204,46908,48512,520908,356328,1263512,134340,544,1450072,22212416
2024-11-20 04:20:41,1858332,37300,648,194556,14080,995132,365716,948224,317204,46908,48512,520908,356328,1263804,134548,544,1450072,22212428
2024-11-20 04:20:44,1858332,37048,648,194556,14080,995260,365716,948352,317204,46908,48512,520908,356328,1264100,134340,544,1450072,22212468
2024-11-20 04:20:46,1858332,37228,648,194556,14080,995228,365716,948320,317204,46908,48512,520908,356328,1264228,134576,544,1450072,22212540
2024-11-20 04:20:49,1858332,37128,648,194556,14080,995416,365716,948508,317204,46908,48512,520908,356328,1264100,134544,544,1450072,22212504
2024-11-20 04:20:52,1858332,36976,648,194556,14080,995520,365716,948612,317204,46908,48512,520908,356328,1264256,134524,544,1450072,22212436
2024-11-20 04:20:54,1858332,35968,648,194556,14080,996412,365716,949504,317204,46908,48512,520908,356328,1265088,134568,544,1450072,22212412
2024-11-20 04:20:57,1858332,35692,648,194556,14080,996516,365716,949608,317204,46908,48512,520908,356328,1265352,134524,544,1450072,22212460
2024-11-20 04:20:59,1858332,35204,648,194556,14080,997452,365720,950544,317208,46908,48512,520908,356332,1266164,134544,544,1450072,22212496
2024-11-20 04:21:02,1858332,34960,648,194556,14080,997692,365720,950784,317208,46908,48512,520908,356332,1266548,134548,544,1450072,22212404
2024-11-20 04:21:05,1858332,34788,648,194556,14080,997556,365720,950648,317208,46908,48512,520908,356332,1266284,134340,544,1450072,22212544
2024-11-20 04:21:07,1858332,34356,648,194556,14080,998124,365724,951216,317212,46908,48512,520908,356336,1266864,134392,544,1450072,22212596
2024-11-20 04:21:10,1858332,34200,648,194556,14080,998332,365724,951424,317212,46908,48512,520908,356336,1267000,134524,544,1450072,22212412
2024-11-20 04:21:12,1858332,33812,648,194556,14080,998488,365724,951580,317212,46908,48512,520908,356336,1267100,134524,544,1450072,22212472
2024-11-20 04:21:15,1858332,33812,648,194556,14080,998724,365724,951816,317212,46908,48512,520908,356336,1267608,134496,544,1450072,22212472
2024-11-20 04:21:18,1858332,33456,648,194556,14080,998628,365724,951720,317212,46908,48512,520908,356336,1267352,134340,544,1450072,22212340
2024-11-20 04:21:20,1858332,33596,648,194820,14080,998712,365988,951804,317212,46908,48776,520908,356336,1267616,134588,544,1450072,22212356
2024-11-20 04:21:23,1858332,32924,648,194820,14080,999672,365988,952764,317212,46908,48776,520908,356336,1268272,134560,544,1450072,22212284
2024-11-20 04:21:26,1858332,38932,648,194820,14080,992804,365988,945896,317212,46908,48776,520908,356336,1261752,134720,544,1450072,22212404
2024-11-20 04:21:28,1858332,38880,648,194820,14080,993136,365988,946228,317212,46908,48776,520908,356336,1261836,134360,544,1450072,22212280
2024-11-20 04:21:31,1858332,38680,648,194820,14080,992976,365988,946068,317212,46908,48776,520908,356336,1261576,134536,544,1450072,22212312
2024-11-20 04:21:33,1858332,38556,648,194820,14080,993364,365988,946456,317212,46908,48776,520908,356336,1262048,134580,544,1450072,22212484
2024-11-20 04:21:36,1858332,38480,648,194820,14080,993788,365988,946880,317212,46908,48776,520908,356336,1262520,134560,544,1450072,22212408
2024-11-20 04:21:39,1858332,38428,648,194820,14080,993576,365988,946668,317212,46908,48776,520908,356336,1262308,134168,544,1450072,22212420
2024-11-20 04:21:41,1858332,38136,648,194820,14080,993804,365988,946896,317212,46908,48776,520908,356336,1262508,134536,544,1450072,22212380
2024-11-20 04:21:44,1858332,38004,648,194820,14080,994080,365988,947172,317212,46908,48776,520908,356336,1263008,134536,544,1450072,22212352
2024-11-20 04:21:46,1858332,37472,648,194820,14080,994500,365988,947592,317212,46908,48776,520908,356340,1263120,134388,544,1450072,22212424
2024-11-20 04:21:49,1858332,37556,648,194820,14080,994564,365988,947656,317212,46908,48776,520908,356340,1263224,134720,544,1450072,22212300
2024-11-20 04:21:51,1858332,37128,648,194820,14080,994792,365988,947884,317212,46908,48776,520908,356340,1263500,134168,544,1450072,22212328
2024-11-20 04:21:54,1858332,37160,648,194820,14080,994904,365988,947996,317212,46908,48776,520908,356340,1263804,134480,544,1450072,22212384
2024-11-20 04:21:57,1858332,36868,648,194820,14080,995704,365992,948796,317216,46908,48776,520908,356344,1264568,134536,544,1450072,22212264
2024-11-20 04:21:59,1858332,36644,648,194820,14080,995612,365992,948704,317216,46908,48776,520908,356344,1264300,134424,544,1450072,22212320
2024-11-20 04:22:02,1858332,36776,648,194820,14080,995936,365996,949028,317220,46908,48776,520908,356348,1264900,134536,544,1450072,22212276
2024-11-20 04:22:04,1858332,36008,648,194820,14080,996364,365996,949456,317220,46908,48776,520908,356348,1265132,134540,544,1450072,22212344
2024-11-20 04:22:07,1858332,35800,648,194820,14080,996388,365996,949480,317220,46908,48776,520908,356348,1265064,134564,544,1450072,22212392
2024-11-20 04:22:10,1858332,35712,648,194820,14080,996528,365996,949620,317220,46908,48776,520908,356348,1265472,134540,544,1450072,22204204
2024-11-20 04:22:12,1858332,35696,648,194820,14080,996752,365996,949844,317220,46908,48776,520908,356348,1265532,134400,544,1450072,22212540
2024-11-20 04:22:15,1858332,34688,648,194820,14080,997104,365996,950196,317220,46908,48776,520908,356348,1266104,134540,544,1450072,22212396
2024-11-20 04:22:17,1858332,34776,648,194820,14080,997376,365996,950468,317220,46908,48776,520908,356348,1265888,134592,544,1450072,22212428
2024-11-20 04:22:20,1858332,34876,648,194820,14080,997504,365996,950596,317220,46908,48776,520908,356348,1266176,134484,544,1450072,22212576
2024-11-20 04:22:23,1858332,34564,648,194820,14080,997356,365996,950448,317220,46908,48776,520908,356348,1266136,134356,544,1450072,22212516
2024-11-20 04:22:25,1858332,34528,648,194820,14080,997744,365996,950836,317220,46908,48776,520908,356348,1266444,134592,544,1450072,22212356
2024-11-20 04:22:28,1858332,33996,648,194820,14080,997988,365996,951080,317220,46908,48776,520908,356348,1266616,134540,544,1450072,22212468
2024-11-20 04:22:30,1858332,33940,648,194820,14084,998296,365996,951388,317220,46908,48776,520908,356352,1267092,134540,544,1450072,22212440
2024-11-20 04:22:33,1858332,33760,648,194820,14084,998492,365996,951584,317220,46908,48776,520908,356352,1267400,134492,544,1450072,22212316
2024-11-20 04:22:36,1858332,33628,648,194820,14084,998680,365996,951772,317220,46908,48776,520908,356352,1267348,134540,544,1450072,22212280
2024-11-20 04:22:38,1858332,33028,648,194820,14084,998876,365996,951968,317220,46908,48776,520908,356352,1267616,134644,544,1450072,22212436
2024-11-20 04:22:41,1858332,33132,648,194820,14084,998688,365996,951780,317220,46908,48776,520908,356352,1267604,134356,544,1450072,22212376
2024-11-20 04:22:43,1858332,32780,648,194820,14084,999084,365996,952176,317220,46908,48776,520908,356352,1267772,134580,544,1450072,22212348
2024-11-20 04:22:46,1858332,32596,648,194820,14084,999060,365996,952152,317220,46908,48776,520908,356352,1267936,134540,544,1450072,22212328
2024-11-20 04:22:48,1858332,32152,648,194820,14084,999728,365996,952820,317220,46908,48776,520908,356352,1268584,134400,544,1450072,22212556
2024-11-20 04:22:51,1858332,41332,648,192012,14084,992336,363944,945996,317408,46340,46536,520908,356180,1261800,134484,544,1450072,22212392
2024-11-20 04:22:53,1858332,40684,648,192012,14084,992948,363944,946608,317408,46340,46536,520908,356180,1262380,134540,544,1450072,22212420
2024-11-20 04:22:56,1858332,40724,648,192012,14080,993124,363904,946784,317368,46340,46536,520908,356220,1262828,134484,544,1450072,22212444
2024-11-20 04:22:59,1858332,40708,648,192012,14080,993424,363904,947084,317368,46340,46536,520908,356220,1262952,134528,544,1450072,22212568
2024-11-20 04:23:02,1858332,40612,648,192012,14080,993404,363904,947064,317368,46340,46536,520908,356220,1262948,134540,544,1450072,22212556
2024-11-20 04:23:04,1858332,39976,648,192012,14080,993696,363904,947356,317368,46340,46536,520908,356220,1263060,134540,544,1450072,22212472
2024-11-20 04:23:06,1858332,39156,648,192012,14080,993992,363904,947652,317368,46340,46536,520908,356220,1263428,134540,544,1450072,22212584
2024-11-20 04:23:08,1858332,39192,648,192012,14080,994296,363912,947956,317376,46340,46536,520908,356228,1263672,134540,544,1450072,22212572
2024-11-20 04:23:10,1858332,38708,648,192012,14080,994740,363912,948400,317376,46340,46536,520908,356228,1264116,134540,544,1450072,22204280
2024-11-20 04:23:12,1858332,38404,648,192012,14080,995128,363912,948788,317376,46340,46536,520908,356228,1264624,134540,544,1450072,22212460
2024-11-20 04:23:14,1858332,37960,648,192012,14080,995120,363912,948780,317376,46340,46536,520908,356228,1264504,134540,544,1450072,22212588
2024-11-20 04:23:16,1858332,38204,648,192012,14080,995108,363912,948768,317376,46340,46536,520908,356228,1264484,134540,544,1450072,22212444
2024-11-20 04:23:19,1858332,38952,648,192012,14080,995396,363912,949056,317376,46340,46536,520908,356228,1264940,134540,544,1450072,22212588
2024-11-20 04:23:21,1858332,38416,648,192012,14080,995848,363912,949508,317376,46340,46536,520908,356228,1265304,134560,544,1450072,22212328
2024-11-20 04:23:24,1858332,38236,648,192012,14080,995764,363912,949424,317376,46340,46536,520908,356228,1265036,134540,544,1450072,22204280
2024-11-20 04:23:27,1858332,38052,648,192012,14080,996136,363912,949796,317376,46340,46536,520908,356228,1265644,134540,544,1450072,22212376
2024-11-20 04:23:29,1858332,37972,648,192012,14080,996208,363912,949868,317376,46340,46536,520908,356228,1265604,134540,544,1450072,22204280
2024-11-20 04:23:32,1858332,37848,648,192012,14080,996420,363912,950080,317376,46340,46536,520908,356228,1266100,134356,544,1450072,22212320
2024-11-20 04:23:34,1858332,37452,648,192012,14080,996820,363912,950480,317376,46340,46536,520908,356228,1266388,134540,544,1450072,22204244
2024-11-20 04:23:37,1858332,37084,648,192012,14080,997404,363912,951064,317376,46340,46536,520908,356228,1266852,134564,544,1450072,22212368
2024-11-20 04:23:40,1858332,36088,648,192012,14080,998248,363912,951908,317376,46340,46536,520908,356228,1267724,134356,544,1450072,22204392
2024-11-20 04:23:42,1858332,36088,648,192012,14080,998284,363912,951944,317376,46340,46536,520908,356228,1267888,134588,544,1450072,22212412
2024-11-20 04:23:45,1858332,35600,648,192012,14080,998400,363912,952060,317376,46340,46536,520908,356228,1268064,134540,544,1450072,22212508
2024-11-20 04:23:47,1858332,35312,648,192012,14080,999008,363912,952668,317376,46340,46536,520908,356228,1268456,134592,544,1450072,22212352
2024-11-20 04:23:50,1858332,41656,648,192012,14080,992548,363912,946208,317376,46340,46536,520908,356232,1261892,134540,544,1450072,22212412
2024-11-20 04:23:52,1858332,41712,648,192012,14080,992836,363916,946496,317380,46340,46536,520908,356232,1262216,134356,544,1450072,22212420
2024-11-20 04:23:55,1858332,41644,648,192012,14080,992952,363916,946612,317380,46340,46536,520908,356232,1262436,134564,544,1450072,22212496
2024-11-20 04:23:58,1858332,41084,648,192012,14076,993248,363916,946908,317380,46340,46536,520908,356236,1262620,134540,544,1450072,22212444
2024-11-20 04:24:00,1858332,41476,648,192012,14076,993156,363916,946816,317380,46340,46536,520908,356236,1262836,134584,544,1450072,22212288
2024-11-20 04:24:03,1858332,40808,648,192012,14076,993516,363916,947176,317380,46340,46536,520908,356236,1263064,134540,544,1450072,22212524
2024-11-20 04:24:05,1858332,40780,648,192012,14076,993420,363916,947080,317380,46340,46536,520908,356236,1262880,134540,544,1450072,22212448
2024-11-20 04:24:08,1858332,40436,648,192012,14056,994100,363916,947760,317380,46340,46536,520908,356256,1263380,134628,544,1450072,22212560
2024-11-20 04:24:11,1858332,40112,648,192380,14056,993920,364288,947580,317380,46340,46908,520908,356256,1263600,134540,544,1450072,22212464
2024-11-20 04:24:13,1858332,37452,648,194688,14124,994308,366676,947968,317464,46340,49212,520908,356272,1263920,134604,544,1450072,22212424
2024-11-20 04:24:16,1858332,37336,648,194688,14124,994128,366676,947788,317464,46340,49212,520908,356272,1263984,134624,544,1450072,22212412
2024-11-20 04:24:18,1858332,37236,648,194688,14124,994700,366684,948360,317472,46340,49212,520908,356280,1264092,134672,544,1450072,22212440
2024-11-20 04:24:21,1858332,36824,648,194688,14124,994884,366684,948544,317472,46340,49212,520908,356280,1264248,134624,544,1450072,22212376
2024-11-20 04:24:24,1858332,36884,648,194688,14124,994804,366684,948464,317472,46340,49212,520908,356280,1264160,134440,544,1450072,22212340
2024-11-20 04:24:26,1858332,36612,648,194688,14124,994828,366684,948488,317472,46340,49212,520908,356280,1264408,134672,544,1450072,22212372
2024-11-20 04:24:29,1858332,36388,648,194688,14124,995504,366688,949164,317476,46340,49212,520908,356284,1265080,134700,544,1450072,22212436
2024-11-20 04:24:32,1858332,36096,648,194688,14124,995888,366688,949548,317476,46340,49212,520908,356284,1265228,134440,544,1450072,22204260
2024-11-20 04:24:34,1858332,35692,648,194688,14124,996012,366688,949672,317476,46340,49212,520908,356284,1265704,134488,544,1450072,22212532
2024-11-20 04:24:37,1858332,35736,648,194688,14124,996212,366684,949872,317472,46340,49212,520908,356284,1265832,134628,544,1450072,22204412
2024-11-20 04:24:40,1858332,35360,648,194688,14124,996732,366684,950392,317472,46340,49212,520908,356284,1266328,134444,544,1450072,22212300
2024-11-20 04:24:42,1858332,35208,648,194688,14124,997248,366684,950908,317472,46340,49212,520908,356284,1266836,134680,544,1450072,22204292
2024-11-20 04:24:45,1858332,35332,648,194688,14124,997184,366684,950844,317472,46340,49212,520908,356284,1266660,134628,544,1450072,22212400
2024-11-20 04:24:47,1858332,34972,648,194688,14124,997404,366684,951064,317472,46340,49212,520908,356284,1267156,134628,544,1450072,22212468
2024-11-20 04:24:50,1858332,34796,648,194688,14124,997740,366684,951400,317472,46340,49212,520908,356284,1267224,134628,544,1450072,22212392
2024-11-20 04:24:52,1858332,34220,648,194688,14124,998276,366684,951936,317472,46340,49212,520908,356284,1268024,134644,544,1450072,22212340
2024-11-20 04:24:55,1858332,33692,648,194688,14124,999028,366684,952688,317472,46340,49212,520908,356284,1268552,134632,544,1450072,22212384
2024-11-20 04:24:58,1858332,39160,648,194688,14124,992896,366684,946556,317472,46340,49212,520908,356344,1262388,134444,544,1450072,22212452
2024-11-20 04:25:01,1858332,39600,648,194688,14124,992728,366684,946388,317472,46340,49212,520908,356344,1262516,134628,544,1450072,22212456
2024-11-20 04:25:03,1858332,39404,648,194688,14124,993080,366684,946740,317472,46340,49212,520908,356344,1262592,134708,544,1450072,22212372
2024-11-20 04:25:06,1858332,38792,648,194688,14124,993520,366684,947180,317472,46340,49212,520908,356344,1263100,134628,544,1450072,22212620
2024-11-20 04:25:08,1858332,38776,648,194688,14124,993768,366692,947428,317480,46340,49212,520908,356352,1263260,134664,544,1450072,22212568
2024-11-20 04:25:11,1858332,38380,648,194688,14124,994008,366692,947668,317480,46340,49212,520908,356352,1263664,134648,544,1450072,22212400
2024-11-20 04:25:14,1858332,38268,648,194688,14124,993860,366692,947520,317480,46340,49212,520908,356352,1263420,134444,544,1450072,22212456
2024-11-20 04:25:16,1858332,38088,648,194688,14124,994132,366692,947792,317480,46340,49212,520908,356352,1263788,134676,544,1450072,22212496
2024-11-20 04:25:19,1858332,37680,648,194688,14124,994160,366692,947820,317480,46340,49212,520908,356352,1263932,134812,544,1450072,22212560
2024-11-20 04:25:22,1858332,37360,648,194688,14124,994668,366692,948328,317480,46340,49212,520908,356352,1264260,134460,544,1450072,22212456
2024-11-20 04:25:24,1858332,35236,648,196152,14180,995188,368052,948844,317400,46344,50652,520908,356220,1264800,135024,544,1450072,22212316
2024-11-20 04:25:27,1858332,34976,648,196152,14180,995248,368072,948904,317400,46344,50672,520908,356220,1264668,134980,544,1450072,22212332
2024-11-20 04:25:29,1858332,34936,648,196152,14180,995432,368072,949088,317400,46344,50672,520908,356220,1265100,134980,544,1450072,22212344
2024-11-20 04:25:32,1858332,34820,648,196152,14180,995724,368072,949380,317400,46344,50672,520908,356220,1265264,135024,544,1450072,22212552
2024-11-20 04:25:35,1858332,34260,648,196152,14180,996340,368072,949996,317400,46344,50672,520908,356220,1265668,134796,544,1450072,22212496
2024-11-20 04:25:37,1858332,33784,648,196152,14180,996560,368072,950216,317400,46344,50672,520908,356220,1266264,134980,544,1450072,22212364
2024-11-20 04:25:40,1858332,33300,648,196152,14180,996760,368072,950416,317400,46344,50672,520908,356220,1266300,134980,544,1450072,22212192
2024-11-20 04:25:42,1858332,38132,736,198896,14180,993292,367916,946136,315312,47156,52604,520908,355880,1259848,135388,540,1450072,22073928
2024-11-20 04:25:44,1858332,37988,736,198928,14180,993416,368040,946260,315312,47156,52728,520908,355880,1259948,135368,540,1450072,22074028
2024-11-20 04:25:47,1858332,37888,736,198928,14180,993416,368040,946260,315312,47156,52728,520908,355880,1259928,135388,540,1450072,22073904
2024-11-20 04:25:49,1858332,38100,736,198928,14180,993724,368040,946568,315312,47156,52728,520908,355880,1260236,135388,540,1450072,22073920
2024-11-20 04:25:51,1858332,37452,736,198928,14180,993684,368040,946528,315312,47156,52728,520908,355884,1260188,135388,540,1450072,22073784
2024-11-20 04:25:53,1858332,37452,736,198928,14180,994072,368044,946916,315316,47156,52728,520908,355884,1260596,135388,540,1450072,22073956
2024-11-20 04:25:55,1858332,37056,736,198928,14180,994000,368044,946844,315316,47156,52728,520908,355884,1260512,135388,540,1450072,22073816
2024-11-20 04:25:57,1858332,37460,736,199000,14180,994140,367968,946836,315316,47304,52652,520908,355884,1260720,135376,540,1450072,22073716
2024-11-20 04:25:59,1858332,37020,736,199000,14176,994524,367972,947220,315320,47304,52652,520908,355892,1261172,135388,540,1450072,22073908
2024-11-20 04:26:02,1858332,36848,736,199000,14176,994644,367976,947340,315324,47304,52652,520908,355896,1261008,135396,540,1450072,22073800
2024-11-20 04:26:04,1858332,36384,736,199000,14176,994952,367976,947648,315324,47304,52652,520908,355896,1261352,135396,540,1450072,22073952
