Timestamp,MemTotal,MemFree,Buffers,Cached,SwapCached,Active,Inactive,Active(anon),Inactive(anon),Active(file),Inactive(file),SwapTotal,SwapFree,AnonPages,Mapped,Shmem,CommitLimit,Committed_AS
2024-11-20 05:09:41,1858332,473192,2664,862360,16944,164456,723080,109324,13288,55132,709792,520908,358792,120800,332660,716,1450072,22178580
2024-11-20 05:09:41,1858332,473192,2664,862360,16944,164456,723080,109324,13288,55132,709792,520908,358792,120800,332660,716,1450072,22178580
2024-11-20 05:09:41,1858332,473192,2664,862360,16944,164456,723080,109324,13288,55132,709792,520908,358792,120800,332660,716,1450072,22178580
2024-11-20 05:09:41,1858332,473192,2664,862360,16944,164456,723080,109324,13288,55132,709792,520908,358792,120800,332660,716,1450072,22178580
2024-11-20 05:09:41,1858332,473192,2664,862360,16944,164456,723080,109324,13288,55132,709792,520908,358792,120800,332660,716,1450072,22178580
2024-11-20 05:09:41,1858332,473192,2664,862360,16944,164456,723080,109324,13288,55132,709792,520908,358792,120800,332660,716,1450072,22178580
2024-11-20 05:09:41,1858332,473192,2664,862360,16944,164456,723080,109324,13288,55132,709792,520908,358792,120800,332660,716,1450072,22178580
2024-11-20 05:09:41,1858332,473192,2664,862360,16944,164456,723080,109324,13288,55132,709792,520908,358792,120800,332660,716,1450072,22178580
2024-11-20 05:09:41,1858332,473192,2664,862360,16944,164456,723080,109324,13288,55132,709792,520908,358792,120800,332660,716,1450072,22178580
2024-11-20 05:09:41,1858332,473192,2664,862360,16944,164456,723080,109324,13288,55132,709792,520908,358792,120800,332660,716,1450072,22178580
2024-11-20 05:09:41,1858332,473192,2664,862360,16944,164456,723080,109324,13288,55132,709792,520908,358792,120800,332660,716,1450072,22178580
2024-11-20 05:09:43,1858332,137592,1280,1211128,16872,523856,718668,97916,32616,425940,686052,520908,358960,128992,713088,716,1450072,22291588
2024-11-20 05:09:45,1858332,137436,1284,1212616,16796,574792,669288,97996,32668,476796,636620,520908,358960,128860,750568,716,1450072,22291676
2024-11-20 05:09:48,1858332,137480,1288,1213240,16428,621356,623184,97784,32596,523572,590588,520908,358960,128996,782568,716,1450072,22291716
2024-11-20 05:09:50,1858332,137756,1288,1214388,15920,654200,591248,97556,32444,556644,558804,520908,358960,129132,819356,716,1450072,22291676
2024-11-20 05:09:52,1858332,137120,1112,1216240,15808,655208,591992,97576,32656,557632,559336,520908,358964,129628,854660,716,1450072,22291660
2024-11-20 05:09:54,1858332,137628,1112,1215640,15808,655396,591336,97660,32532,557736,558804,520908,358964,129584,887260,716,1450072,22291696
2024-11-20 05:09:56,1858332,137548,1120,1216768,15808,655848,592196,97692,32612,558156,559584,520908,359112,129564,923172,716,1450072,22291264
2024-11-20 05:09:58,1858332,137716,168,1217236,15808,655980,591568,97744,32488,558236,559080,520908,359112,129488,929116,716,1450072,22291380
2024-11-20 05:10:00,1858332,137628,176,1217464,15928,656668,591452,98092,32812,558576,558640,520908,359184,130144,916112,716,1450072,22291432
2024-11-20 05:10:02,1858332,137084,184,1218072,15928,656676,592240,98260,32776,558416,559464,520908,359184,130476,913520,716,1450072,22291408
2024-11-20 05:10:04,1858332,137360,184,1217056,15928,656560,591540,98460,32876,558100,558664,520908,359184,131104,910028,716,1450072,22291392
2024-11-20 05:10:06,1858332,143204,192,1216888,15928,650904,591892,92896,33068,558008,558824,520908,359200,125208,904312,716,1450072,22291540
2024-11-20 05:10:09,1858332,140444,192,1218656,15928,652540,592216,93252,32968,559288,559248,520908,359200,125532,902936,716,1450072,22291372
2024-11-20 05:10:11,1858332,139044,188,1220236,15928,652792,593660,93352,32932,559440,560728,520908,359200,125792,898236,716,1450072,22291444
2024-11-20 05:10:13,1858332,139912,188,1218812,15900,651988,592756,93452,32884,558536,559872,520908,359204,125712,893900,716,1450072,22291288
2024-11-20 05:10:15,1858332,139480,520,1217768,15864,660632,585320,94784,32848,565848,552472,520908,359212,127256,889504,716,1450072,22291976
2024-11-20 05:10:17,1858332,107176,564,1216112,15856,686988,591368,128524,33212,558464,558156,520908,359216,161312,888504,716,1450072,22382936
2024-11-20 05:10:19,1858332,71388,564,1213776,15852,721852,591760,164844,34552,557008,557208,520908,359216,198676,888324,716,1450072,22419680
2024-11-20 05:10:21,1858332,31812,204,749748,14432,856100,502440,531604,177308,324496,325132,520908,357164,708820,438904,708,1450072,23193848
2024-11-20 05:10:23,1858332,33948,116,238204,14284,1000412,356836,932116,287104,68296,69732,520908,356424,1218924,109412,680,1450072,22180372
2024-11-20 05:10:26,1858332,44988,216,192152,14164,987328,361780,949040,307856,38288,53924,520908,355432,1256220,114208,676,1450072,22194468
2024-11-20 05:10:28,1858332,39048,436,214972,11960,997520,376716,944644,314700,52876,62016,520908,349408,1258116,131024,676,1450072,24116272
2024-11-20 05:10:31,1858332,25164,332,202008,12444,994464,368092,945448,315152,49016,52940,520908,345396,1258808,133368,656,1450072,24117656
2024-11-20 05:10:33,1858332,51048,324,190116,12616,973932,365232,933320,315404,40612,49828,520908,345588,1246604,123312,668,1450072,20274692
2024-11-20 05:10:35,1858332,48512,328,190932,12640,975368,365776,934500,315388,40868,50388,520908,345604,1248028,124932,672,1450072,22194276
2024-11-20 05:10:38,1858332,37824,416,198048,12440,990688,372984,949356,316288,41332,56696,520908,346544,1264548,136020,676,1450072,24121304
2024-11-20 05:10:40,1858332,54932,360,185984,12620,971984,360920,930360,316004,41624,44916,520908,346812,1244432,125044,676,1450072,20274484
2024-11-20 05:10:43,1858332,54400,360,186300,12616,972332,361116,930708,315996,41624,45120,520908,346856,1244896,124728,676,1450072,20274532
2024-11-20 05:10:45,1858332,47408,368,191552,13544,972780,367908,931156,317524,41624,50384,520908,347604,1246768,125496,676,1450072,20274412
2024-11-20 05:10:48,1858332,49040,368,190052,14192,972668,367100,931044,318220,41624,48880,520908,347864,1247284,125484,676,1450072,20274504
2024-11-20 05:10:50,1858332,47012,368,190152,15708,973124,370004,931496,321012,41628,48992,520908,349384,1250584,125484,676,1450072,20274312
2024-11-20 05:10:53,1858332,47028,368,190168,15716,973364,370068,931736,321076,41628,48992,520908,349388,1250904,125556,676,1450072,20274300
2024-11-20 05:10:56,1858332,46340,344,193044,16700,975972,374944,934224,323212,41748,51732,520908,350768,1255648,128660,676,1450072,22195436
2024-11-20 05:10:58,1858332,43904,352,191740,16700,982224,373336,940448,323404,41776,49932,520908,351164,1262168,133168,676,1450072,24116504
2024-11-20 05:11:01,1858332,50500,352,195368,16756,974828,377428,932852,323620,41976,53808,520908,351384,1254652,127264,676,1450072,20274576
2024-11-20 05:11:03,1858332,50656,360,195448,16756,975364,377528,933388,323620,41976,53908,520908,351384,1255128,127268,676,1450072,20274432
2024-11-20 05:11:06,1858332,47196,360,198940,16788,975864,380068,933888,322748,41976,57320,520908,351388,1254720,127664,676,1450072,20274468
2024-11-20 05:11:08,1858332,47020,360,199212,16788,976196,380392,934220,322712,41976,57680,520908,351392,1254900,127452,676,1450072,20274628
2024-11-20 05:11:11,1858332,46780,360,199212,16788,976332,380376,934356,322696,41976,57680,520908,351392,1254924,127500,676,1450072,20274524
2024-11-20 05:11:14,1858332,46832,360,199212,16788,976280,380364,934304,322684,41976,57680,520908,351392,1254984,127688,676,1450072,20274304
2024-11-20 05:11:16,1858332,46648,360,199212,16788,976392,380364,934416,322684,41976,57680,520908,351392,1255156,127664,676,1450072,20274392
2024-11-20 05:11:19,1858332,46408,360,199212,16788,976728,380332,934752,322652,41976,57680,520908,351392,1255524,127504,676,1450072,20274520
2024-11-20 05:11:21,1858332,45860,360,199656,16788,977056,380752,935080,322628,41976,58124,520908,351392,1255716,127572,676,1450072,20274468
2024-11-20 05:11:24,1858332,47188,352,197924,16788,977096,378948,935120,322564,41976,56384,520908,351392,1255860,127704,676,1450072,20274564
2024-11-20 05:11:26,1858332,47352,352,197948,16792,977212,378976,935236,322568,41976,56408,520908,351392,1256096,127508,676,1450072,20274688
2024-11-20 05:11:29,1858332,47400,352,197948,16792,977448,378976,935472,322568,41976,56408,520908,351420,1256208,127356,676,1450072,20274528
2024-11-20 05:11:31,1858332,47076,352,198000,16792,977584,378980,935608,322572,41976,56408,520908,351516,1255924,127652,676,1450072,20274504
2024-11-20 05:11:34,1858332,47112,352,198000,16792,977828,379012,935852,322552,41976,56460,520908,351516,1256504,127732,676,1450072,20274416
2024-11-20 05:11:36,1858332,46844,352,198000,16792,977984,379012,936008,322552,41976,56460,520908,351516,1256788,127556,676,1450072,20274552
2024-11-20 05:11:39,1858332,46496,352,198000,16788,978268,379028,936292,322568,41976,56460,520908,351536,1257012,127736,676,1450072,20274420
2024-11-20 05:11:41,1858332,50492,348,196284,16788,978672,377168,936648,322476,42024,54692,520908,351536,1257152,127992,676,1450072,20274396
2024-11-20 05:11:44,1858332,50592,348,196284,16788,978732,377164,936708,322472,42024,54692,520908,351536,1257120,127908,676,1450072,20274532
2024-11-20 05:11:46,1858332,50268,348,196400,16788,978820,377280,936796,322472,42024,54808,520908,351536,1257244,127904,676,1450072,20274480
2024-11-20 05:11:49,1858332,50128,348,196400,16788,978960,377280,936936,322472,42024,54808,520908,351536,1257552,128096,676,1450072,20274436
2024-11-20 05:11:51,1858332,46432,388,197900,16744,981652,378672,939560,322412,42092,56260,520908,354056,1259948,128632,684,1450072,20274432
2024-11-20 05:11:54,1858332,46184,388,197900,16744,982008,378680,939916,322408,42092,56272,520908,354060,1260352,128576,684,1450072,20274536
2024-11-20 05:11:56,1858332,45824,388,197900,16744,982004,378688,939912,322416,42092,56272,520908,354064,1260376,128644,684,1450072,20274528
2024-11-20 05:11:59,1858332,45448,388,197900,16744,982348,378688,940256,322416,42092,56272,520908,354064,1260836,128588,684,1450072,20274480
2024-11-20 05:12:01,1858332,45136,388,197900,16744,982320,378688,940228,322416,42092,56272,520908,354092,1260712,128648,684,1450072,20274664
2024-11-20 05:12:04,1858332,42892,396,196476,16744,986216,377020,943944,322372,42272,54648,520908,354192,1264712,132332,684,1450072,22195908
2024-11-20 05:12:07,1858332,39444,360,192920,16744,996308,371240,952452,321736,43856,49504,520908,354248,1272484,136952,684,1450072,24116464
2024-11-20 05:12:09,1858332,38392,368,198004,16624,998516,373004,953952,319188,44564,53816,520908,354116,1271448,139680,684,1450072,24117652
2024-11-20 05:12:12,1858332,19904,412,203112,16572,996252,373292,949888,316648,46364,56644,520908,353880,1264780,137656,688,1450072,22197128
2024-11-20 05:12:15,1858332,50752,344,182828,16904,982844,357480,940316,316980,42528,40500,520908,354084,1255244,128668,688,1450072,20282684
2024-11-20 05:12:17,1858332,51004,352,182968,16904,982968,357672,940352,316896,42616,40776,520908,354084,1255308,128640,688,1450072,20282600
2024-11-20 05:12:20,1858332,45068,352,188684,16904,983636,363344,941020,316900,42616,46444,520908,354088,1255732,128732,688,1450072,20282604
2024-11-20 05:12:22,1858332,46000,352,188684,16904,982408,363392,939792,316900,42616,46492,520908,354096,1254444,128548,688,1450072,20282592
2024-11-20 05:12:25,1858332,48420,360,188328,16900,982824,362600,940208,316512,42616,46088,520908,354224,1254708,128816,688,1450072,20282704
2024-11-20 05:12:28,1858332,48540,360,188328,16904,982564,362648,939948,316504,42616,46144,520908,354228,1254392,128792,688,1450072,20282616
2024-11-20 05:12:30,1858332,47016,360,189936,16904,983124,364216,940508,316464,42616,47752,520908,354256,1254864,128856,688,1450072,20282616
2024-11-20 05:12:32,1858332,46048,360,189936,16904,983356,364220,940740,316468,42616,47752,520908,354264,1255184,128648,688,1450072,20282780
2024-11-20 05:12:35,1858332,45804,360,190136,16900,983516,364416,940900,316464,42616,47952,520908,354268,1255220,128796,688,1450072,20282568
2024-11-20 05:12:38,1858332,45396,360,190132,16904,983680,364400,941064,316448,42616,47952,520908,354268,1255340,128852,688,1450072,20282492
2024-11-20 05:12:40,1858332,47036,368,189448,16900,983880,363524,941264,316252,42616,47272,520908,354312,1255368,128804,688,1450072,20282544
2024-11-20 05:12:42,1858332,46824,368,189448,16900,983960,363512,941344,316240,42616,47272,520908,354312,1255220,128736,688,1450072,20282760
2024-11-20 05:12:45,1858332,46664,368,189448,16900,984224,363516,941608,316244,42616,47272,520908,354316,1255896,128920,688,1450072,20282804
2024-11-20 05:12:47,1858332,46452,368,189448,16900,984408,363512,941792,316240,42616,47272,520908,354316,1256044,128736,688,1450072,20282676
2024-11-20 05:12:50,1858332,46536,368,189448,16900,984528,363528,941912,316256,42616,47272,520908,354368,1256048,128920,688,1450072,20282668
2024-11-20 05:12:52,1858332,46572,368,189448,16900,984600,363528,941984,316256,42616,47272,520908,354368,1256300,128920,688,1450072,20282680
2024-11-20 05:12:55,1858332,48964,368,190880,17048,985868,364660,943156,316060,42712,48600,520908,354416,1256896,129356,684,1450072,20282604
2024-11-20 05:12:57,1858332,47308,368,192048,17048,986252,365872,943540,316092,42712,49780,520908,354436,1257636,129412,684,1450072,20282788
2024-11-20 05:13:00,1858332,46296,368,192920,17252,987296,367184,944560,316608,42736,50576,520908,354824,1259036,130212,684,1450072,20282772
2024-11-20 05:13:02,1858332,46168,368,192920,17252,987388,367228,944652,316600,42736,50628,520908,354824,1259156,130080,684,1450072,20282764
2024-11-20 05:13:05,1858332,46004,368,192920,17252,987580,367228,944844,316600,42736,50628,520908,354824,1259332,130036,684,1450072,20282628
2024-11-20 05:13:07,1858332,45832,368,192920,17252,987836,367228,945100,316600,42736,50628,520908,354824,1259480,130224,684,1450072,20282736
2024-11-20 05:13:09,1858332,38196,368,193024,17252,995432,367340,952696,316608,42736,50732,520908,354836,1266972,130232,684,1450072,20282556
2024-11-20 05:13:12,1858332,37596,368,193024,17252,995816,367344,953080,316612,42736,50732,520908,354836,1267632,130232,684,1450072,20282676
2024-11-20 05:13:14,1858332,37548,368,193040,17252,995744,367360,953008,316612,42736,50748,520908,354836,1267616,130056,684,1450072,20282704
2024-11-20 05:13:17,1858332,37008,368,193040,17252,996008,367360,953272,316612,42736,50748,520908,354836,1267864,130056,684,1450072,20282700
2024-11-20 05:13:19,1858332,37188,368,193040,17252,996044,367360,953308,316612,42736,50748,520908,354836,1267744,130292,684,1450072,20282624
2024-11-20 05:13:22,1858332,36916,368,193040,17252,996220,367360,953484,316612,42736,50748,520908,354836,1267948,130240,684,1450072,20282592
2024-11-20 05:13:24,1858332,36504,368,193040,17252,996772,367352,954036,316604,42736,50748,520908,355044,1268500,130276,684,1450072,20282744
2024-11-20 05:13:27,1858332,42452,368,193040,17252,990280,367364,947544,316616,42736,50748,520908,355148,1261952,130244,684,1450072,20282760
2024-11-20 05:13:29,1858332,43004,368,193040,17252,990372,367364,947636,316616,42736,50748,520908,355148,1262028,130260,684,1450072,20282612
2024-11-20 05:13:32,1858332,42976,368,193040,17252,990708,367364,947972,316616,42736,50748,520908,355152,1262380,130188,684,1450072,20282648
2024-11-20 05:13:34,1858332,42976,368,193040,17252,990824,367356,948088,316608,42736,50748,520908,355152,1262632,130060,684,1450072,20282692
2024-11-20 05:13:37,1858332,42928,368,193040,17252,990880,367356,948144,316608,42736,50748,520908,355152,1262604,130260,684,1450072,20282584
2024-11-20 05:13:40,1858332,42752,368,193040,17252,991232,367356,948496,316608,42736,50748,520908,355156,1263188,130244,684,1450072,20282668
2024-11-20 05:13:42,1858332,42636,368,193040,17252,991352,367360,948616,316612,42736,50748,520908,355156,1263084,130260,684,1450072,20282640
2024-11-20 05:13:45,1858332,42328,368,193040,17252,991420,367372,948684,316624,42736,50748,520908,355344,1263032,130248,684,1450072,20282720
2024-11-20 05:13:47,1858332,42504,368,193040,17252,991520,367364,948784,316616,42736,50748,520908,355344,1263388,130108,684,1450072,20282824
2024-11-20 05:13:50,1858332,41824,368,193040,17252,992024,367364,949288,316616,42736,50748,520908,355344,1263672,130248,684,1450072,20282688
2024-11-20 05:13:52,1858332,41792,368,193040,17252,991840,367364,949104,316616,42736,50748,520908,355344,1263556,130116,684,1450072,20282544
2024-11-20 05:13:55,1858332,41340,368,193040,17252,992316,367364,949580,316616,42736,50748,520908,355344,1263940,130248,684,1450072,20282636
2024-11-20 05:13:57,1858332,41200,368,193040,17248,992244,367368,949508,316620,42736,50748,520908,355356,1263916,130248,684,1450072,20282736
2024-11-20 05:14:00,1858332,41112,368,193040,17248,992796,367368,950060,316620,42736,50748,520908,355356,1264544,130140,684,1450072,20282652
2024-11-20 05:14:03,1858332,41184,368,193040,17248,992576,367368,949840,316620,42736,50748,520908,355356,1264432,130248,684,1450072,20282772
2024-11-20 05:14:05,1858332,40924,368,193040,17248,993040,367368,950304,316620,42736,50748,520908,355356,1264692,130272,684,1450072,20282604
2024-11-20 05:14:08,1858332,40760,368,193040,17248,992980,367368,950244,316620,42736,50748,520908,355356,1264824,130064,684,1450072,20282736
2024-11-20 05:14:10,1858332,40576,368,193040,17248,992940,367372,950204,316624,42736,50748,520908,355396,1264664,130248,684,1450072,20282692
2024-11-20 05:14:12,1858332,40324,368,193040,17248,993120,367372,950384,316624,42736,50748,520908,355396,1264736,130064,684,1450072,20282556
2024-11-20 05:14:15,1858332,40212,368,193040,17244,993852,367372,951116,316624,42736,50748,520908,355400,1265556,130248,684,1450072,20274528
2024-11-20 05:14:17,1858332,37216,368,195124,17244,995292,368948,952556,316228,42736,52720,520908,355400,1266748,130580,684,1450072,20284264
2024-11-20 05:14:20,1858332,38868,368,193652,17244,994584,368556,951848,317264,42736,51292,520908,355388,1266756,130580,684,1450072,20284204
2024-11-20 05:14:22,1858332,38556,368,193544,17244,994472,368484,951736,317232,42736,51252,520908,355388,1266872,130624,684,1450072,20284196
2024-11-20 05:14:25,1858332,38232,368,193544,17244,995016,368484,952280,317232,42736,51252,520908,355388,1267264,130524,684,1450072,20284260
2024-11-20 05:14:28,1858332,38336,368,193544,17244,994784,368484,952048,317232,42736,51252,520908,355388,1267124,130396,684,1450072,20284156
2024-11-20 05:14:30,1858332,37916,368,193544,17244,995444,368484,952708,317232,42736,51252,520908,355388,1267764,130584,684,1450072,20284148
2024-11-20 05:14:32,1858332,37848,368,193544,17244,995128,368484,952392,317232,42736,51252,520908,355388,1267596,130764,684,1450072,20284116
2024-11-20 05:14:35,1858332,38108,368,193544,17244,995480,368484,952744,317232,42736,51252,520908,355388,1267784,130504,684,1450072,20284132
2024-11-20 05:14:37,1858332,37572,368,193544,17244,995620,368484,952884,317232,42736,51252,520908,355388,1267872,130580,684,1450072,20284156
2024-11-20 05:14:40,1858332,37452,368,193544,17240,995900,368484,953164,317232,42736,51252,520908,355392,1268308,130580,684,1450072,20284200
2024-11-20 05:14:42,1858332,37340,368,193544,17240,995788,368484,953052,317232,42736,51252,520908,355392,1268132,130396,684,1450072,20284212
2024-11-20 05:14:45,1858332,37232,368,193544,17240,996052,368484,953316,317232,42736,51252,520908,355392,1268500,130580,684,1450072,20284252
2024-11-20 05:14:48,1858332,36880,368,193544,17240,996180,368484,953444,317232,42736,51252,520908,355392,1268576,130580,684,1450072,20284184
2024-11-20 05:14:50,1858332,36952,368,193544,17240,996504,368484,953768,317232,42736,51252,520908,355392,1268860,130584,684,1450072,20284232
2024-11-20 05:14:53,1858332,37212,368,192624,17240,995916,367732,953180,317872,42736,49860,520908,355392,1268948,130396,684,1450072,20284244
2024-11-20 05:14:55,1858332,38280,368,192012,17236,996260,367560,953524,317844,42736,49716,520908,355400,1269148,130580,684,1450072,20284140
2024-11-20 05:14:58,1858332,40356,368,192104,17236,996184,365420,953448,315648,42736,49772,520908,355488,1266852,130616,684,1450072,20284280
2024-11-20 05:15:00,1858332,40188,368,192104,17236,996412,365460,953676,315648,42736,49812,520908,355488,1267148,130676,684,1450072,20284368
2024-11-20 05:15:03,1858332,46080,368,192104,17236,990464,365468,947728,315656,42736,49812,520908,355516,1261336,130652,684,1450072,20284388
2024-11-20 05:15:05,1858332,46016,368,192104,17236,990936,365468,948200,315656,42736,49812,520908,355516,1261596,130624,684,1450072,20284320
2024-11-20 05:15:08,1858332,44188,368,193088,17224,991536,366440,948800,315644,42736,50796,520908,355920,1262300,130768,684,1450072,20284392
2024-11-20 05:15:11,1858332,44260,368,193088,17224,991332,366440,948596,315644,42736,50796,520908,355920,1262260,130824,684,1450072,20284192
2024-11-20 05:15:13,1858332,43656,368,193088,17224,991600,366440,948864,315644,42736,50796,520908,355920,1262292,130824,684,1450072,20284260
2024-11-20 05:15:16,1858332,44088,368,193088,17224,991524,366440,948788,315644,42736,50796,520908,355920,1262080,130824,684,1450072,20284380
2024-11-20 05:15:18,1858332,43712,368,193088,17224,991952,366440,949216,315644,42736,50796,520908,355920,1262608,130660,684,1450072,20284376
2024-11-20 05:15:21,1858332,43448,368,193088,17224,992220,366440,949484,315644,42736,50796,520908,355920,1262884,130828,684,1450072,20284052
2024-11-20 05:15:24,1858332,43040,368,193088,17224,992600,366440,949864,315644,42736,50796,520908,355920,1263256,130824,684,1450072,20284192
2024-11-20 05:15:26,1858332,42736,368,193088,17224,992924,366440,950188,315644,42736,50796,520908,355920,1263576,130692,684,1450072,20284232
2024-11-20 05:15:29,1858332,42784,368,193088,17224,992892,366440,950156,315644,42736,50796,520908,355920,1263744,130824,684,1450072,20284208
2024-11-20 05:15:32,1858332,42392,368,193088,17224,993276,366440,950540,315644,42736,50796,520908,355920,1263816,131008,684,1450072,20284252
2024-11-20 05:15:34,1858332,41900,368,193088,17224,993944,366440,951208,315644,42736,50796,520908,355920,1264728,130660,684,1450072,20284268
2024-11-20 05:15:37,1858332,41568,368,193088,17224,994292,366440,951556,315644,42736,50796,520908,355920,1265164,130824,684,1450072,20284180
2024-11-20 05:15:39,1858332,40860,368,193088,17200,995220,366464,952484,315668,42736,50796,520908,355972,1266152,130644,684,1450072,20284276
2024-11-20 05:15:42,1858332,40400,368,193088,17200,995544,366464,952808,315668,42736,50796,520908,355972,1266352,130828,684,1450072,20284188
2024-11-20 05:15:44,1858332,40076,368,193088,17200,996008,366464,953272,315668,42736,50796,520908,355972,1266836,130828,684,1450072,20284168
2024-11-20 05:15:47,1858332,39544,368,193088,17200,996432,366464,953696,315668,42736,50796,520908,355972,1267172,130864,684,1450072,20284148
2024-11-20 05:15:50,1858332,39524,368,193084,17204,996452,366464,953716,315668,42736,50796,520908,355976,1267284,130828,684,1450072,20284224
2024-11-20 05:15:52,1858332,39048,368,193088,17204,996636,366472,953900,315676,42736,50796,520908,355976,1267384,130844,684,1450072,20284256
2024-11-20 05:15:55,1858332,39236,368,193088,17204,996628,366472,953892,315676,42736,50796,520908,355976,1267444,130644,684,1450072,20284104
2024-11-20 05:15:57,1858332,38444,368,193088,17204,997744,366476,955008,315680,42736,50796,520908,355980,1268508,130664,684,1450072,20284284
2024-11-20 05:16:00,1858332,44924,368,193088,17204,990960,366476,948224,315680,42736,50796,520908,355980,1261788,130828,684,1450072,20284252
2024-11-20 05:16:03,1858332,44868,368,193088,17204,991064,366476,948328,315680,42736,50796,520908,355980,1261772,130828,684,1450072,20284280
2024-11-20 05:16:05,1858332,44964,368,193088,17204,991112,366476,948376,315680,42736,50796,520908,355980,1261948,130848,684,1450072,20284256
2024-11-20 05:16:08,1858332,44856,368,193088,17204,991108,366476,948372,315680,42736,50796,520908,355980,1261896,130828,684,1450072,20284288
2024-11-20 05:16:10,1858332,44960,368,193088,17204,991180,366476,948444,315680,42736,50796,520908,355980,1262040,130832,684,1450072,20284172
2024-11-20 05:16:13,1858332,44656,368,193088,17204,991576,366476,948840,315680,42736,50796,520908,355980,1262268,130772,684,1450072,20284260
2024-11-20 05:16:15,1858332,44244,368,193088,17204,991920,366476,949184,315680,42736,50796,520908,355980,1262960,130828,684,1450072,20284324
2024-11-20 05:16:18,1858332,43848,368,193088,17204,991876,366476,949140,315680,42736,50796,520908,355980,1262776,130828,684,1450072,20284104
2024-11-20 05:16:20,1858332,43864,368,193088,17204,992368,366476,949632,315680,42736,50796,520908,355980,1263004,130828,684,1450072,20284212
2024-11-20 05:16:23,1858332,43668,368,193088,17204,992172,366476,949436,315680,42736,50796,520908,355980,1262888,130828,684,1450072,20284260
2024-11-20 05:16:25,1858332,43568,368,193088,17204,992800,366476,950064,315680,42736,50796,520908,355980,1263544,130828,684,1450072,20284332
2024-11-20 05:16:27,1858332,43360,368,193088,17204,992644,366476,949908,315680,42736,50796,520908,355980,1263328,130828,684,1450072,20284280
2024-11-20 05:16:30,1858332,39772,384,193512,17216,995556,366940,952820,315704,42736,51236,520908,355992,1266776,133972,684,1450072,22205616
2024-11-20 05:16:33,1858332,34264,432,192220,17160,1000068,367684,957332,317692,42736,49992,520908,356208,1272972,137612,684,1450072,24126216
2024-11-20 05:16:36,1858332,41888,456,194728,17164,991688,370980,948384,319036,43304,51944,520908,356244,1265380,131412,684,1450072,20284500
2024-11-20 05:16:38,1858332,40576,456,196460,17220,991824,372684,948472,319044,43352,53640,520908,356248,1265248,131724,684,1450072,20284184
2024-11-20 05:16:41,1858332,40536,464,196412,17320,992280,372692,948928,319052,43352,53640,520908,356248,1265748,131516,684,1450072,20284360
2024-11-20 05:16:44,1858332,44064,464,196460,17348,988748,372688,945396,319040,43352,53648,520908,356256,1262196,130964,684,1450072,20284240
2024-11-20 05:16:46,1858332,43928,472,196460,17356,988688,372696,945336,319048,43352,53648,520908,356256,1262276,131036,684,1450072,20284280
2024-11-20 05:16:49,1858332,43148,472,197348,17356,988920,373536,945568,318992,43352,54544,520908,356264,1262476,131008,684,1450072,20284292
2024-11-20 05:16:52,1858332,42608,472,197348,17356,989124,373536,945772,318992,43352,54544,520908,356264,1262616,130984,684,1450072,20284236
2024-11-20 05:16:54,1858332,42472,508,197356,17356,989660,373592,946300,319012,43360,54580,520908,356324,1263172,131100,684,1450072,20284176
2024-11-20 05:16:57,1858332,41920,508,197356,17356,990032,373592,946672,319012,43360,54580,520908,356324,1263504,131056,684,1450072,20284140
2024-11-20 05:16:59,1858332,41788,516,197356,17356,990240,373600,946880,319012,43360,54588,520908,356324,1263724,131108,684,1450072,20284184
2024-11-20 05:17:02,1858332,41380,516,197356,17356,990644,373600,947284,319012,43360,54588,520908,356324,1264260,131100,684,1450072,20284264
2024-11-20 05:17:04,1858332,41384,516,197356,17356,990712,373600,947352,319012,43360,54588,520908,356324,1264112,130872,684,1450072,20284176
2024-11-20 05:17:07,1858332,41040,516,197356,17356,991024,373612,947664,319024,43360,54588,520908,356336,1264428,131088,684,1450072,20284400
2024-11-20 05:17:09,1858332,41228,516,197356,17356,990992,373596,947632,319008,43360,54588,520908,356336,1264564,131064,684,1450072,20284260
2024-11-20 05:17:12,1858332,40712,516,197356,17352,991308,373596,947948,319008,43360,54588,520908,356340,1264776,131076,684,1450072,20284348
2024-11-20 05:17:15,1858332,40756,516,197356,17352,991268,373596,947908,319008,43360,54588,520908,356340,1264636,131064,684,1450072,20284236
2024-11-20 05:17:17,1858332,40428,516,197356,17352,991440,373596,948080,319008,43360,54588,520908,356340,1264956,130924,684,1450072,20284140
2024-11-20 05:17:20,1858332,40108,516,197356,17352,991796,373600,948436,319012,43360,54588,520908,356344,1265092,131064,684,1450072,20284244
2024-11-20 05:17:23,1858332,39788,516,197356,17352,991924,373600,948564,319012,43360,54588,520908,356344,1265400,131064,684,1450072,20284232
2024-11-20 05:17:25,1858332,39848,516,197356,17352,992104,373600,948744,319012,43360,54588,520908,356344,1265516,131064,684,1450072,20284296
2024-11-20 05:17:28,1858332,40108,516,197356,17352,992188,373600,948828,319012,43360,54588,520908,356344,1265880,131248,684,1450072,20284216
2024-11-20 05:17:30,1858332,39896,516,197356,17352,992280,373600,948920,319012,43360,54588,520908,356344,1265712,130972,684,1450072,20284400
2024-11-20 05:17:33,1858332,39756,516,197356,17352,992448,373600,949088,319012,43360,54588,520908,356344,1265952,131064,684,1450072,20284256
2024-11-20 05:17:35,1858332,39700,516,197356,17352,992492,373600,949132,319012,43360,54588,520908,356344,1265912,131248,684,1450072,20284184
2024-11-20 05:17:38,1858332,39380,516,197356,17352,993032,373600,949672,319012,43360,54588,520908,356344,1266536,131064,684,1450072,20284136
2024-11-20 05:17:41,1858332,39240,516,197356,17352,993056,373600,949696,319012,43360,54588,520908,356344,1266548,131088,684,1450072,20284212
2024-11-20 05:17:44,1858332,38480,516,197356,17352,993084,373600,949724,319012,43360,54588,520908,356344,1266756,130880,684,1450072,20284200
2024-11-20 05:17:46,1858332,38792,516,197356,17352,993180,373600,949820,319012,43360,54588,520908,356344,1266896,131064,684,1450072,20284228
2024-11-20 05:17:49,1858332,38364,516,197356,17352,993380,373600,950020,319012,43360,54588,520908,356344,1266884,130880,684,1450072,20284144
2024-11-20 05:17:52,1858332,38236,516,197356,17352,993768,373600,950408,319012,43360,54588,520908,356344,1267300,131064,684,1450072,20284304
2024-11-20 05:17:54,1858332,37692,516,197356,17352,993948,373596,950588,319008,43360,54588,520908,356344,1267456,131084,684,1450072,20284252
2024-11-20 05:17:57,1858332,37276,564,197364,17352,994544,373644,951160,319024,43384,54620,520908,356360,1268048,131092,684,1450072,20284308
2024-11-20 05:18:00,1858332,37424,564,197364,17352,994324,373648,950940,319028,43384,54620,520908,356364,1268196,131068,684,1450072,20284156
2024-11-20 05:18:02,1858332,36604,572,197364,17352,994984,373660,951600,319032,43384,54628,520908,356368,1268536,130904,684,1450072,20284304
2024-11-20 05:18:05,1858332,36424,572,197364,17352,995576,373660,952192,319032,43384,54628,520908,356368,1269308,130884,684,1450072,20284220
2024-11-20 05:18:07,1858332,42924,572,197364,17352,988444,373660,945060,319032,43384,54628,520908,356432,1261984,131068,684,1450072,20284240
2024-11-20 05:18:10,1858332,43216,572,197364,17352,988604,373660,945220,319032,43384,54628,520908,356432,1262028,131092,684,1450072,20284272
2024-11-20 05:18:13,1858332,42740,572,197364,17352,988628,373660,945244,319032,43384,54628,520908,356432,1262268,131068,684,1450072,20284232
2024-11-20 05:18:15,1858332,42164,572,197364,17352,989540,373660,946156,319032,43384,54628,520908,356432,1263080,131088,684,1450072,20284160
2024-11-20 05:18:18,1858332,41928,572,197364,17352,989560,373660,946176,319032,43384,54628,520908,356432,1263136,130884,684,1450072,20284128
2024-11-20 05:18:20,1858332,41140,572,197364,17352,990396,373664,947012,319036,43384,54628,520908,356484,1264136,131088,684,1450072,20284208
2024-11-20 05:18:23,1858332,41116,572,197364,17352,990892,373664,947508,319036,43384,54628,520908,356484,1264272,131068,684,1450072,20284160
2024-11-20 05:18:25,1858332,40832,572,197364,17352,990912,373664,947528,319036,43384,54628,520908,356484,1264484,130884,684,1450072,20284292
2024-11-20 05:18:28,1858332,40300,572,197364,17352,991168,373664,947784,319036,43384,54628,520908,356484,1264612,131092,684,1450072,20284256
2024-11-20 05:18:31,1858332,40328,572,197364,17352,991216,373664,947832,319036,43384,54628,520908,356484,1264760,131068,684,1450072,20284284
2024-11-20 05:18:33,1858332,39888,572,197364,17352,991140,373664,947756,319036,43384,54628,520908,356484,1264572,130936,684,1450072,20284236
2024-11-20 05:18:36,1858332,40148,572,197364,17352,991632,373664,948248,319036,43384,54628,520908,356484,1265340,130884,684,1450072,20284192
2024-11-20 05:18:38,1858332,39564,572,197364,17352,991972,373664,948588,319036,43384,54628,520908,356484,1265368,130884,684,1450072,20284332
2024-11-20 05:18:41,1858332,39544,572,197364,17352,992120,373664,948736,319036,43384,54628,520908,356484,1265600,131092,684,1450072,20284164
2024-11-20 05:18:44,1858332,39740,572,197364,17352,992132,373664,948748,319036,43384,54628,520908,356484,1265756,131068,684,1450072,20284168
2024-11-20 05:18:46,1858332,39652,572,197364,17352,992296,373664,948912,319036,43384,54628,520908,356484,1265840,130988,684,1450072,20284188
2024-11-20 05:18:49,1858332,39128,572,197364,17352,992468,373640,949084,319012,43384,54628,520908,356484,1266008,130884,684,1450072,20284228
2024-11-20 05:18:51,1858332,39020,572,197364,17352,992728,373640,949344,319012,43384,54628,520908,356484,1266268,130884,684,1450072,20284240
2024-11-20 05:18:54,1858332,38616,572,197364,17352,992828,373640,949444,319012,43384,54628,520908,356484,1266304,131068,684,1450072,20284268
2024-11-20 05:18:56,1858332,39012,572,197364,17352,993256,373640,949872,319012,43384,54628,520908,356484,1266908,130932,684,1450072,20284132
2024-11-20 05:18:59,1858332,38372,572,197364,17352,993476,373640,950092,319012,43384,54628,520908,356484,1266784,131012,684,1450072,20284164
2024-11-20 05:19:02,1858332,38544,572,197364,17352,993248,373640,949864,319012,43384,54628,520908,356484,1266708,131068,684,1450072,20284408
2024-11-20 05:19:04,1858332,38060,572,197364,17352,993644,373640,950260,319012,43384,54628,520908,356484,1267032,131040,684,1450072,20284276
2024-11-20 05:19:06,1858332,38040,572,197364,17352,993576,373640,950192,319012,43384,54628,520908,356488,1267100,131068,684,1450072,20284252
2024-11-20 05:19:09,1858332,37760,572,197364,17352,994096,373636,950712,319008,43384,54628,520908,356488,1267492,131068,684,1450072,20284360
2024-11-20 05:19:11,1858332,37472,572,197364,17352,994012,373636,950628,319008,43384,54628,520908,356488,1267476,131068,684,1450072,20284344
2024-11-20 05:19:14,1858332,37264,572,197364,17352,994360,373636,950976,319008,43384,54628,520908,356488,1267880,130884,684,1450072,20284252
2024-11-20 05:19:16,1858332,39032,572,195736,17352,994924,371920,951540,318920,43384,53000,520908,356488,1268332,131120,684,1450072,20284264
2024-11-20 05:19:19,1858332,44628,572,195736,17352,988504,371920,945120,318920,43384,53000,520908,356580,1261568,131068,684,1450072,20284384
2024-11-20 05:19:21,1858332,44800,572,195736,17352,988840,371920,945456,318920,43384,53000,520908,356580,1262244,131088,684,1450072,20284292
2024-11-20 05:19:24,1858332,44840,572,195736,17352,988840,371920,945456,318920,43384,53000,520908,356580,1262268,130884,684,1450072,20284236
2024-11-20 05:19:26,1858332,45236,572,195736,17352,988952,371920,945568,318920,43384,53000,520908,356580,1262324,131120,684,1450072,20284228
2024-11-20 05:19:29,1858332,44604,572,195736,17352,989220,371920,945836,318920,43384,53000,520908,356580,1262552,130964,684,1450072,20284128
2024-11-20 05:19:31,1858332,44336,572,195736,17352,989236,371920,945852,318920,43384,53000,520908,356580,1262520,131068,684,1450072,20284276
2024-11-20 05:19:34,1858332,44160,572,195736,17352,989528,371920,946144,318920,43384,53000,520908,356580,1263016,131084,684,1450072,20284160
2024-11-20 05:19:36,1858332,43004,572,195736,17360,989740,371928,946356,318928,43384,53000,520908,356580,1263156,131068,684,1450072,20284368
2024-11-20 05:19:38,1858332,42752,572,195736,17360,990192,371928,946808,318928,43384,53000,520908,356580,1263648,131068,684,1450072,20284396
2024-11-20 05:19:40,1858332,42504,572,195736,17360,990124,371928,946740,318928,43384,53000,520908,356580,1263424,131068,684,1450072,20284160
2024-11-20 05:19:42,1858332,42168,572,195736,17360,990264,371928,946880,318928,43384,53000,520908,356580,1263540,131068,684,1450072,20284304
2024-11-20 05:19:45,1858332,39700,572,197760,17360,990608,374036,947224,318928,43384,55108,520908,356580,1263964,131068,684,1450072,20284324
2024-11-20 05:19:47,1858332,43780,636,201344,17360,989772,373448,946264,315168,43508,58280,520908,356612,1259028,134284,684,1450072,20156056
2024-11-20 05:19:49,1858332,44144,636,202112,17360,989376,373692,945368,314968,44008,58724,520908,356612,1258084,131540,684,1450072,20153636
2024-11-20 05:19:51,1858332,44352,636,202112,17360,989336,373748,945328,314968,44008,58780,520908,356612,1257972,131592,684,1450072,20153652
2024-11-20 05:19:53,1858332,44516,636,202112,17360,989580,373748,945572,314968,44008,58780,520908,356612,1258260,131592,684,1450072,20153652
2024-11-20 05:19:55,1858332,44184,636,202112,17360,989768,373748,945760,314968,44008,58780,520908,356612,1258592,131540,684,1450072,20153772
2024-11-20 05:19:57,1858332,43792,636,202112,17360,989856,373784,945848,314968,44008,58816,520908,356612,1258616,131544,684,1450072,20153628
2024-11-20 05:19:59,1858332,43952,636,202112,17360,989872,373784,945864,314968,44008,58816,520908,356612,1258548,131544,684,1450072,20153728
2024-11-20 05:20:02,1858332,44092,636,202112,17360,990232,373784,946224,314968,44008,58816,520908,356612,1258976,131528,684,1450072,20153588
2024-11-20 05:20:04,1858332,43768,636,202112,17360,990180,373784,946172,314968,44008,58816,520908,356612,1259048,131544,684,1450072,20153584
2024-11-20 05:20:06,1858332,43796,636,202112,17360,990716,373784,946708,314968,44008,58816,520908,356612,1259528,131524,684,1450072,20153616
2024-11-20 05:20:08,1858332,43488,636,202112,17360,990604,373784,946596,314968,44008,58816,520908,356612,1259340,131560,684,1450072,20153664
2024-11-20 05:20:10,1858332,43372,636,202112,17360,990928,373784,946920,314968,44008,58816,520908,356612,1259720,131580,684,1450072,20153596
