Timestamp,MemTotal,MemFree,Buffers,Cached,SwapCached,Active,Inactive,Active(anon),Inactive(anon),Active(file),Inactive(file),SwapTotal,SwapFree,AnonPages,Mapped,Shmem,CommitLimit,Committed_AS
2024-11-20 02:54:17,1858332,297076,2392,1015052,15624,166920,877296,115880,10964,51040,866332,520908,366632,125396,367324,716,1450072,24106964
2024-11-20 02:54:17,1858332,297076,2392,1015052,15624,166920,877296,115880,10964,51040,866332,520908,366632,125396,367324,716,1450072,24106964
2024-11-20 02:54:17,1858332,297076,2392,1015052,15624,166920,877296,115880,10964,51040,866332,520908,366632,125396,367324,716,1450072,24106964
2024-11-20 02:54:17,1858332,297076,2392,1015052,15624,166920,877296,115880,10964,51040,866332,520908,366632,125396,367324,716,1450072,24106964
2024-11-20 02:54:17,1858332,297076,2392,1015052,15624,166920,877296,115880,10964,51040,866332,520908,366632,125396,367324,716,1450072,24106964
2024-11-20 02:54:17,1858332,297076,2392,1015052,15624,166920,877296,115880,10964,51040,866332,520908,366632,125396,367324,716,1450072,24106964
2024-11-20 02:54:17,1858332,297076,2392,1015052,15624,166920,877296,115880,10964,51040,866332,520908,366632,125396,367324,716,1450072,24106964
2024-11-20 02:54:17,1858332,297076,2392,1015052,15624,166920,877296,115880,10964,51040,866332,520908,366632,125396,367324,716,1450072,24106964
2024-11-20 02:54:17,1858332,297076,2392,1015052,15624,166920,877296,115880,10964,51040,866332,520908,366632,125396,367324,716,1450072,24106964
2024-11-20 02:54:17,1858332,297076,2392,1015052,15624,166920,877296,115880,10964,51040,866332,520908,366632,125396,367324,716,1450072,24106964
2024-11-20 02:54:17,1858332,297076,2392,1015052,15624,166920,877296,115880,10964,51040,866332,520908,366632,125396,367324,716,1450072,24106964
2024-11-20 02:54:20,1858332,132356,1024,1195200,15480,591680,638560,100604,33740,491076,604820,520908,366596,132984,754888,716,1450072,24211644
2024-11-20 02:54:22,1858332,131924,1016,1195856,15152,640436,590844,101068,33888,539368,556956,520908,366560,133656,789408,716,1450072,24211480
2024-11-20 02:54:24,1858332,131676,960,1198096,14844,649120,583836,100612,33604,548508,550232,520908,366548,133424,826624,716,1450072,24211468
2024-11-20 02:54:26,1858332,131456,968,1199092,14796,650028,584036,100756,33516,549272,550520,520908,366548,133488,858772,716,1450072,24211568
2024-11-20 02:54:28,1858332,132792,960,1198044,14652,649648,583596,100580,33656,549068,549940,520908,366548,133616,897404,716,1450072,24211436
2024-11-20 02:54:30,1858332,131988,656,1199032,14652,650668,583804,101308,33616,549360,550188,520908,366548,134248,912876,716,1450072,24211452
2024-11-20 02:54:32,1858332,130628,136,1202432,14652,650596,585992,100864,33576,549732,552416,520908,366548,133752,907392,716,1450072,24211528
2024-11-20 02:54:34,1858332,132492,144,1199460,14652,650240,583844,100676,33788,549564,550056,520908,366548,134008,902432,716,1450072,24211492
2024-11-20 02:54:37,1858332,131888,156,1199744,14652,650204,584088,100708,33752,549496,550336,520908,366548,133708,899624,716,1450072,24211332
2024-11-20 02:54:39,1858332,131208,156,1200872,14652,650380,584624,100888,33728,549492,550896,520908,366548,134156,897124,716,1450072,24211384
2024-11-20 02:54:41,1858332,130576,164,1201484,14652,650376,586060,101280,33680,549096,552380,520908,366548,134356,893984,716,1450072,24211532
2024-11-20 02:54:43,1858332,130540,164,1200768,14652,651200,585076,101580,33776,549620,551300,520908,366548,134460,891528,716,1450072,24211472
2024-11-20 02:54:45,1858332,131780,172,1199500,14652,650708,583224,101224,33864,549484,549360,520908,366548,134260,887784,716,1450072,24211356
2024-11-20 02:54:47,1858332,132384,168,1198412,14652,650604,582988,101580,33832,549024,549156,520908,366548,134908,885732,716,1450072,24211372
2024-11-20 02:54:49,1858332,130244,176,1200700,14652,651232,584804,101632,33788,549600,551016,520908,366548,134720,885360,716,1450072,24211396
2024-11-20 02:54:51,1858332,119160,656,1195928,14652,663432,583180,115988,34396,547444,548784,520908,366548,149848,881540,716,1450072,24301912
2024-11-20 02:54:53,1858332,93180,656,1196104,14652,689148,583572,141608,34380,547540,549192,520908,366548,175652,881724,716,1450072,24324944
2024-11-20 02:54:56,1858332,33748,648,1163456,14620,732960,599132,200988,67160,531972,531972,520908,366540,267916,856968,716,1450072,25130340
2024-11-20 02:54:58,1858332,33708,212,630308,11224,868836,467492,604724,201416,264112,266076,520908,361876,806200,242916,716,1450072,25130288
2024-11-20 02:55:00,1858332,34280,116,215676,10200,984332,352372,927004,294192,57328,58180,520908,360328,1220984,109588,708,1450072,24108676
2024-11-20 02:55:02,1858332,34060,256,195656,9764,986960,367392,943992,314660,42968,52732,520908,358052,1257588,123624,696,1450072,22211692
2024-11-20 02:55:05,1858332,27732,428,210132,8432,990440,374520,940816,313600,49624,60920,520908,345560,1253480,131948,488,1450072,24132448
2024-11-20 02:55:07,1858332,44612,436,199896,7756,977756,368132,931676,313880,46080,54252,520908,338252,1243988,132300,468,1450072,22211724
2024-11-20 02:55:10,1858332,42752,436,201508,7796,977988,370004,931784,313972,46204,56032,520908,338300,1244304,132312,468,1450072,22211832
2024-11-20 02:55:12,1858332,45848,452,203860,7932,973104,371768,926396,313844,46708,57924,520908,338276,1238680,126116,464,1450072,22210532
2024-11-20 02:55:14,1858332,44668,552,203376,8312,974216,371916,927464,314484,46752,57432,520908,338956,1239884,127756,468,1450072,22211064
2024-11-20 02:55:16,1858332,47256,528,199616,10396,973432,369948,926624,316320,46808,53628,520908,344076,1241172,127632,468,1450072,22211124
2024-11-20 02:55:18,1858332,45876,528,201120,10432,973620,371452,926812,316368,46808,55084,520908,344124,1241516,127776,468,1450072,22211112
2024-11-20 02:55:21,1858332,46448,528,201272,10460,974308,370812,927500,315528,46808,55284,520908,344280,1241356,127844,468,1450072,22211076
2024-11-20 02:55:23,1858332,45316,552,199432,10488,977372,368796,930564,315460,46808,53336,520908,344340,1244640,130388,468,1450072,24132332
2024-11-20 02:55:26,1858332,46132,460,191532,11160,982596,362052,936756,315928,45840,46124,520908,344988,1247132,130956,468,1450072,26052944
2024-11-20 02:55:29,1858332,48384,444,197472,11868,975724,368796,929732,316892,45992,51904,520908,345924,1244912,129216,468,1450072,22210948
2024-11-20 02:55:31,1858332,45880,328,199256,12344,977416,370128,930804,316868,46612,53260,520908,345768,1245980,130876,476,1450072,22211020
2024-11-20 02:55:34,1858332,47544,328,196748,12452,977756,368204,931144,317604,46612,50600,520908,346520,1247088,130752,476,1450072,22210916
2024-11-20 02:55:36,1858332,47724,320,194924,13632,978056,368356,931352,319532,46704,48824,520908,347236,1249152,130780,476,1450072,22211004
2024-11-20 02:55:39,1858332,46616,324,195028,13808,978356,369328,931652,320396,46704,48932,520908,347932,1250452,130800,476,1450072,22211096
2024-11-20 02:55:41,1858332,45332,324,195248,14568,978252,370824,931548,321672,46704,49152,520908,348484,1251644,130808,476,1450072,22210992
2024-11-20 02:55:44,1858332,48632,324,191656,14664,977992,367672,931868,321524,46124,46148,520908,348336,1249708,129092,476,1450072,22210904
2024-11-20 02:55:47,1858332,49944,324,193528,14768,976600,369108,930432,321136,46168,47972,520908,348404,1249840,129120,476,1450072,20290720
2024-11-20 02:55:49,1858332,49064,324,193672,14848,977160,369260,930992,321136,46168,48124,520908,348420,1250272,129044,476,1450072,20290776
2024-11-20 02:55:52,1858332,49380,324,193736,14896,977180,369236,931012,321112,46168,48124,520908,348420,1250480,129136,476,1450072,20290740
2024-11-20 02:55:55,1858332,48844,324,193740,14904,977544,369264,931376,321084,46168,48180,520908,348424,1250500,129136,476,1450072,20290728
2024-11-20 02:55:57,1858332,45644,324,197024,14912,977700,372588,931532,321124,46168,51464,520908,348476,1250888,129344,476,1450072,20290756
2024-11-20 02:55:59,1858332,45476,324,197024,14912,977548,372588,931380,321124,46168,51464,520908,348476,1250684,129404,476,1450072,20290568
2024-11-20 02:56:02,1858332,44596,368,197032,14920,978612,372664,932432,321160,46180,51504,520908,348528,1251716,129356,476,1450072,20290548
2024-11-20 02:56:04,1858332,44468,368,197032,14920,978604,372664,932424,321160,46180,51504,520908,348528,1251848,129124,476,1450072,20290656
2024-11-20 02:56:07,1858332,44184,376,197024,14920,978968,372704,932788,321200,46180,51504,520908,348568,1252132,129364,476,1450072,20290800
2024-11-20 02:56:10,1858332,43800,376,197052,14900,979208,372704,933028,321200,46180,51504,520908,348664,1252436,129496,476,1450072,20290752
2024-11-20 02:56:12,1858332,46628,368,194280,14900,979332,369716,933152,321164,46180,48552,520908,348588,1252264,129508,476,1450072,20290580
2024-11-20 02:56:15,1858332,44768,364,194948,14956,980564,370400,934292,321076,46272,49324,520908,348672,1253596,129760,476,1450072,20290676
2024-11-20 02:56:17,1858332,50444,364,194948,14956,974624,370408,928352,321084,46272,49324,520908,348772,1247916,129108,476,1450072,20290724
2024-11-20 02:56:20,1858332,47208,364,197108,15124,975816,373136,929544,321652,46272,51484,520908,349148,1249508,129584,476,1450072,20290684
2024-11-20 02:56:23,1858332,46928,364,197228,15124,975668,373256,929396,321652,46272,51604,520908,349148,1249260,129684,476,1450072,20290616
2024-11-20 02:56:25,1858332,46628,364,197440,15128,976256,373428,929984,321656,46272,51772,520908,349148,1250012,129624,476,1450072,20290748
2024-11-20 02:56:28,1858332,46416,364,194892,15132,977960,370636,931688,321656,46272,48980,520908,349148,1251624,130628,476,1450072,22210844
2024-11-20 02:56:30,1858332,49420,392,190928,15128,979008,366668,933680,320660,45328,46008,520908,348960,1252632,132184,476,1450072,22211068
2024-11-20 02:56:33,1858332,49444,392,193128,15128,977368,368800,931828,320536,45540,48264,520908,348856,1250744,130456,476,1450072,20290624
2024-11-20 02:56:35,1858332,49220,400,193204,15128,977624,368880,932084,320540,45540,48340,520908,348856,1250848,130276,476,1450072,20290652
2024-11-20 02:56:38,1858332,46396,412,193192,15128,979852,368888,934312,320540,45540,48348,520908,348884,1253232,132116,476,1450072,22210892
2024-11-20 02:56:40,1858332,45332,412,193324,15128,980300,369036,934752,320564,45548,48472,520908,348884,1253600,132072,476,1450072,22210964
2024-11-20 02:56:43,1858332,49060,412,193464,15124,977060,369144,931452,320592,45608,48552,520908,349024,1250272,131484,476,1450072,22211016
2024-11-20 02:56:46,1858332,46864,412,195132,15108,977116,370760,931508,320596,45608,50164,520908,349248,1250712,131608,476,1450072,22210972
2024-11-20 02:56:48,1858332,46728,412,195148,15108,977284,370888,931676,320652,45608,50236,520908,349248,1250532,131464,476,1450072,22211084
2024-11-20 02:56:51,1858332,47212,412,194412,15104,977960,369412,932352,319900,45608,49512,520908,349208,1250588,131800,476,1450072,22219180
2024-11-20 02:56:53,1858332,47360,412,194560,15104,978540,369376,932852,319808,45688,49568,520908,349220,1250872,131748,476,1450072,22219132
2024-11-20 02:56:56,1858332,47088,412,194560,15104,978752,369384,933064,319816,45688,49568,520908,349220,1251108,131948,476,1450072,22219096
2024-11-20 02:56:58,1858332,46784,412,194560,15104,978560,369384,932872,319816,45688,49568,520908,349220,1251012,132108,476,1450072,22219108
2024-11-20 02:57:01,1858332,45672,412,195852,15100,978936,370624,933248,319816,45688,50808,520908,349324,1251420,132292,476,1450072,22219080
2024-11-20 02:57:03,1858332,45232,412,195856,15100,978928,370676,933240,319812,45688,50864,520908,349324,1251212,132344,476,1450072,22219092
2024-11-20 02:57:06,1858332,44632,412,195856,15100,979424,370676,933736,319812,45688,50864,520908,349336,1251840,132160,476,1450072,22219288
2024-11-20 02:57:09,1858332,46952,412,192932,15100,979908,367380,934136,319524,45772,47856,520908,349268,1251984,131972,476,1450072,22219168
2024-11-20 02:57:11,1858332,46828,412,192932,15100,980084,367376,934312,319520,45772,47856,520908,349320,1252092,132460,476,1450072,22219208
2024-11-20 02:57:13,1858332,46760,412,192932,15100,980448,367376,934676,319520,45772,47856,520908,349320,1252476,132156,476,1450072,22219084
2024-11-20 02:57:16,1858332,46816,412,192932,15100,980712,367376,934940,319520,45772,47856,520908,349320,1252720,132240,476,1450072,22219228
2024-11-20 02:57:18,1858332,46332,412,192932,15100,981040,367376,935268,319520,45772,47856,520908,349320,1253220,132156,476,1450072,22219040
2024-11-20 02:57:21,1858332,46176,412,192932,15100,981380,367376,935608,319520,45772,47856,520908,349320,1253376,132180,476,1450072,22219164
2024-11-20 02:57:23,1858332,45804,424,192920,15100,981712,367376,935940,319520,45772,47856,520908,349324,1253712,132340,476,1450072,22219168
2024-11-20 02:57:26,1858332,44560,516,194232,15100,981788,368772,935996,319532,45792,49240,520908,349336,1253744,132200,476,1450072,22219136
2024-11-20 02:57:28,1858332,43756,516,194232,15100,982680,368772,936888,319532,45792,49240,520908,349336,1254780,132164,476,1450072,22219200
2024-11-20 02:57:31,1858332,43424,524,194224,15100,982780,368772,936988,319532,45792,49240,520908,349336,1254792,132224,476,1450072,22219124
2024-11-20 02:57:34,1858332,43260,524,194232,15100,983164,368780,937372,319532,45792,49248,520908,349336,1255200,132164,476,1450072,22219100
2024-11-20 02:57:36,1858332,42732,524,194232,15100,983576,368780,937784,319532,45792,49248,520908,349336,1255584,132308,476,1450072,22219100
2024-11-20 02:57:39,1858332,35512,524,194232,15100,990712,368616,944920,319532,45792,49084,520908,349336,1262764,132240,476,1450072,22211108
2024-11-20 02:57:41,1858332,38116,524,191432,15100,991284,365788,945448,319384,45836,46404,520908,349316,1263184,132068,476,1450072,22219380
2024-11-20 02:57:44,1858332,44084,524,191432,15100,985080,365788,939244,319384,45836,46404,520908,349408,1256772,132184,476,1450072,22219232
2024-11-20 02:57:47,1858332,44232,524,191432,15100,984864,365792,939028,319388,45836,46404,520908,349408,1256484,132372,476,1450072,22219216
2024-11-20 02:57:49,1858332,44360,524,191432,15100,985624,365788,939788,319384,45836,46404,520908,349412,1257428,132424,476,1450072,22219128
2024-11-20 02:57:52,1858332,44336,524,191432,15068,985596,365536,939760,319132,45836,46404,520908,349448,1257140,132272,476,1450072,22219196
2024-11-20 02:57:55,1858332,44236,524,191440,15060,985972,365536,940136,319132,45836,46404,520908,349468,1257732,132188,476,1450072,22219168
2024-11-20 02:57:58,1858332,43680,524,191432,15060,986160,365564,940324,319160,45836,46404,520908,349484,1257940,132192,476,1450072,22219352
2024-11-20 02:58:00,1858332,43588,524,191432,15060,986240,365564,940404,319160,45836,46404,520908,349484,1257800,132192,476,1450072,22219260
2024-11-20 02:58:03,1858332,43352,524,191432,15060,986420,365568,940584,319164,45836,46404,520908,349492,1258124,132192,476,1450072,22219148
2024-11-20 02:58:05,1858332,43048,524,191432,15060,986896,365568,941060,319164,45836,46404,520908,349492,1258544,132192,476,1450072,22219184
2024-11-20 02:58:08,1858332,43176,524,191432,15060,986816,365572,940980,319168,45836,46404,520908,349524,1258516,132192,476,1450072,22219180
2024-11-20 02:58:10,1858332,42800,524,191432,15060,987196,365576,941360,319172,45836,46404,520908,349524,1258728,132480,476,1450072,22219092
2024-11-20 02:58:13,1858332,42608,524,191432,15060,987212,365576,941376,319172,45836,46404,520908,349524,1258888,132192,476,1450072,22218996
2024-11-20 02:58:16,1858332,42508,524,191432,15060,987644,365576,941808,319172,45836,46404,520908,349604,1259160,132012,476,1450072,22219164
2024-11-20 02:58:18,1858332,42704,524,191432,15060,987564,365580,941728,319176,45836,46404,520908,349604,1259300,132128,476,1450072,22219208
2024-11-20 02:58:21,1858332,42144,524,191432,15060,987920,365580,942084,319176,45836,46404,520908,349604,1259416,132012,476,1450072,22219236
2024-11-20 02:58:23,1858332,41912,524,191432,15060,988004,365580,942168,319176,45836,46404,520908,349604,1259268,132340,476,1450072,22219180
2024-11-20 02:58:26,1858332,41716,524,191432,15060,988324,365580,942488,319176,45836,46404,520908,349604,1259964,132284,476,1450072,22219248
2024-11-20 02:58:28,1858332,41944,524,191432,15060,988144,365580,942308,319176,45836,46404,520908,349604,1259908,132012,476,1450072,22219188
2024-11-20 02:58:31,1858332,41336,524,191436,15056,988704,365580,942868,319176,45836,46404,520908,349676,1260288,132380,476,1450072,22219244
2024-11-20 02:58:34,1858332,41564,524,191432,15056,988624,365584,942788,319180,45836,46404,520908,349676,1260112,132196,476,1450072,22219172
2024-11-20 02:58:36,1858332,41464,524,191432,15056,988916,365584,943080,319180,45836,46404,520908,349676,1260524,132252,476,1450072,22219236
2024-11-20 02:58:39,1858332,41104,524,191432,15056,989140,365584,943304,319180,45836,46404,520908,349676,1260808,132380,476,1450072,22219248
2024-11-20 02:58:41,1858332,41104,524,191432,15056,989172,365588,943336,319184,45836,46404,520908,349680,1260776,132280,476,1450072,22219152
2024-11-20 02:58:44,1858332,40648,524,191432,15056,989264,365596,943428,319192,45836,46404,520908,349688,1260988,132196,476,1450072,22219200
2024-11-20 02:58:46,1858332,36968,524,193524,15056,991088,367688,945252,319192,45836,48496,520908,349688,1262756,132608,476,1450072,22220676
2024-11-20 02:58:49,1858332,36344,524,193524,15056,991280,367688,945444,319192,45836,48496,520908,349688,1262868,132632,476,1450072,22220688
2024-11-20 02:58:51,1858332,41052,520,191200,15056,989772,365052,943792,319028,45980,46024,520908,349636,1261088,130848,476,1450072,20300372
2024-11-20 02:58:54,1858332,38364,520,191200,15044,992092,365064,946112,319040,45980,46024,520908,349660,1263496,132564,476,1450072,22220580
2024-11-20 02:58:57,1858332,37832,520,191200,15044,992612,365076,946632,319052,45980,46024,520908,349692,1263864,132636,476,1450072,22220680
2024-11-20 02:58:59,1858332,35844,520,192008,15036,994192,365872,948212,319064,45980,46808,520908,349712,1265404,132608,476,1450072,22220688
2024-11-20 02:59:02,1858332,42112,520,192008,15036,987528,365904,941548,319072,45980,46832,520908,349720,1258868,132648,476,1450072,22220684
2024-11-20 02:59:05,1858332,42168,520,192008,15036,987356,365904,941376,319072,45980,46832,520908,349720,1258900,132608,476,1450072,22220524
2024-11-20 02:59:07,1858332,41896,520,192028,15036,987376,365948,941396,319096,45980,46852,520908,349744,1258652,132624,476,1450072,22220832
2024-11-20 02:59:10,1858332,41760,520,192028,15036,987884,365948,941904,319096,45980,46852,520908,349744,1259204,132624,476,1450072,22220712
2024-11-20 02:59:12,1858332,43908,520,192028,15036,987808,363376,941828,316524,45980,46852,520908,349744,1256724,132808,476,1450072,22220832
2024-11-20 02:59:15,1858332,44308,520,192028,15036,987616,363376,941636,316524,45980,46852,520908,349744,1256388,132680,476,1450072,22220720
2024-11-20 02:59:17,1858332,43976,520,192028,15036,987780,363380,941800,316528,45980,46852,520908,349748,1256528,132624,476,1450072,22220760
2024-11-20 02:59:20,1858332,43960,520,192028,15036,987860,363380,941880,316528,45980,46852,520908,349748,1256668,132704,476,1450072,22220644
2024-11-20 02:59:23,1858332,43884,520,192028,15036,988020,363380,942040,316528,45980,46852,520908,349748,1256788,132440,476,1450072,22220704
2024-11-20 02:59:25,1858332,43556,520,192028,15036,988300,363384,942320,316532,45980,46852,520908,349752,1257104,132784,476,1450072,22220572
2024-11-20 02:59:28,1858332,43568,520,192028,15032,988580,363384,942600,316532,45980,46852,520908,349760,1257248,132624,476,1450072,22220548
2024-11-20 02:59:31,1858332,43116,520,192028,15032,988844,363388,942864,316536,45980,46852,520908,349760,1257672,132624,476,1450072,22220596
2024-11-20 02:59:33,1858332,42976,520,192028,15032,988752,363384,942772,316532,45980,46852,520908,349760,1257388,132712,476,1450072,22220664
2024-11-20 02:59:36,1858332,42476,520,192028,15032,988896,363384,942916,316532,45980,46852,520908,349760,1257924,132624,476,1450072,22220624
2024-11-20 02:59:39,1858332,42608,520,192028,15032,988944,363388,942964,316536,45980,46852,520908,349764,1257992,132624,476,1450072,22220676
2024-11-20 02:59:41,1858332,42472,520,192028,15032,989184,363388,943204,316536,45980,46852,520908,349764,1257984,132660,476,1450072,22220716
2024-11-20 02:59:44,1858332,42296,520,192028,15032,989688,363392,943708,316540,45980,46852,520908,349816,1258568,132808,476,1450072,22220692
2024-11-20 02:59:46,1858332,41736,520,192028,15032,989728,363392,943748,316540,45980,46852,520908,349816,1258616,132624,476,1450072,22220620
2024-11-20 02:59:49,1858332,42060,520,192028,15032,989972,363392,943992,316540,45980,46852,520908,349816,1258704,132808,476,1450072,22220720
2024-11-20 02:59:51,1858332,41908,520,192028,15032,990132,363396,944152,316544,45980,46852,520908,349820,1258964,132808,476,1450072,22220728
2024-11-20 02:59:54,1858332,41564,520,192028,15032,990372,363396,944392,316544,45980,46852,520908,349820,1259164,132624,476,1450072,22220844
2024-11-20 02:59:56,1858332,40896,512,191560,15132,991876,362244,945500,316272,46376,45972,520908,349556,1260276,132840,476,1450072,22220708
2024-11-20 02:59:59,1858332,40912,512,191560,15132,992080,362252,945704,316272,46376,45980,520908,349556,1260236,132964,476,1450072,22220596
2024-11-20 03:00:02,1858332,40540,520,191552,15132,992468,362252,946092,316272,46376,45980,520908,349560,1260948,132840,476,1450072,22220740
2024-11-20 03:00:04,1858332,40164,520,191560,15132,992868,362264,946492,316276,46376,45988,520908,349560,1260932,133024,476,1450072,22220708
2024-11-20 03:00:07,1858332,40024,520,191560,15132,992764,362268,946388,316280,46376,45988,520908,349580,1261124,132840,476,1450072,22220664
2024-11-20 03:00:09,1858332,39704,520,191560,15132,993156,362284,946780,316296,46376,45988,520908,349580,1261436,133024,476,1450072,22220696
2024-11-20 03:00:12,1858332,39668,520,191560,15132,992944,362284,946568,316296,46376,45988,520908,349580,1261260,132840,476,1450072,22220696
2024-11-20 03:00:15,1858332,39244,520,191560,15132,993500,362284,947124,316296,46376,45988,520908,349580,1261492,133020,476,1450072,22220752
2024-11-20 03:00:17,1858332,39356,520,191560,15132,993536,362284,947160,316296,46376,45988,520908,349580,1261720,132840,476,1450072,22220700
2024-11-20 03:00:20,1858332,39284,520,191560,15132,993916,362284,947540,316296,46376,45988,520908,349580,1261992,132840,476,1450072,22220732
2024-11-20 03:00:22,1858332,38868,520,191560,15132,993892,362284,947516,316296,46376,45988,520908,349580,1262060,132848,476,1450072,22220812
2024-11-20 03:00:25,1858332,45780,492,186856,15144,990428,359872,946712,315956,43716,43916,520908,349292,1260832,131316,476,1450072,20300428
2024-11-20 03:00:28,1858332,53044,492,186856,15144,982776,359884,939060,315968,43716,43916,520908,349352,1253488,131172,476,1450072,20300364
2024-11-20 03:00:30,1858332,53068,492,186856,15144,983140,359888,939424,315972,43716,43916,520908,349356,1253428,131232,476,1450072,20300432
2024-11-20 03:00:33,1858332,51724,492,186856,15136,984104,359912,940388,315996,43716,43916,520908,349392,1255140,132012,476,1450072,22220328
2024-11-20 03:00:36,1858332,36520,540,194472,15140,990988,367396,947124,316016,43864,51380,520908,349560,1261652,136748,476,1450072,24141752
2024-11-20 03:00:39,1858332,44748,548,193880,15144,985152,365824,940632,315640,44520,50184,520908,349304,1254624,131740,476,1450072,20300568
2024-11-20 03:00:41,1858332,45140,556,193880,15144,985272,365844,940752,315644,44520,50200,520908,349304,1254740,132008,476,1450072,20300496
2024-11-20 03:00:44,1858332,42180,576,193880,15132,987664,365884,943144,315664,44520,50220,520908,349336,1257056,133652,476,1450072,22220600
2024-11-20 03:00:47,1858332,41972,576,193976,15132,987412,365940,942892,315664,44520,50276,520908,349336,1257040,133480,476,1450072,22220696
2024-11-20 03:00:49,1858332,41600,576,193976,15132,988004,365980,943484,315664,44520,50316,520908,349336,1257548,133928,476,1450072,22220560
2024-11-20 03:00:52,1858332,41120,576,194016,15132,988340,365932,943820,315576,44520,50356,520908,349336,1257644,133700,476,1450072,22220808
2024-11-20 03:00:55,1858332,40720,576,194016,15132,988744,365932,944224,315576,44520,50356,520908,349336,1258168,133588,476,1450072,22220852
2024-11-20 03:00:57,1858332,40612,576,194016,15132,989016,365932,944496,315576,44520,50356,520908,349336,1258352,133832,476,1450072,22220832
2024-11-20 03:01:00,1858332,40184,576,194016,15132,989568,365936,945048,315580,44520,50356,520908,349340,1258868,133796,476,1450072,22220692
2024-11-20 03:01:03,1858332,40224,576,194016,15132,989680,365936,945160,315580,44520,50356,520908,349340,1258936,133772,476,1450072,22220704
2024-11-20 03:01:05,1858332,39792,576,194016,15132,989704,365936,945184,315580,44520,50356,520908,349340,1259428,133820,476,1450072,22220732
2024-11-20 03:01:08,1858332,39560,576,194016,15132,989852,365936,945332,315580,44520,50356,520908,349340,1259216,133772,476,1450072,22220644
2024-11-20 03:01:10,1858332,39428,576,194016,15132,990140,365936,945620,315580,44520,50356,520908,349340,1259488,133956,476,1450072,22220752
2024-11-20 03:01:13,1858332,39548,576,194016,15132,990140,365880,945620,315524,44520,50356,520908,349340,1259436,133880,476,1450072,22220616
2024-11-20 03:01:16,1858332,39616,576,194016,15132,990120,365880,945600,315524,44520,50356,520908,349340,1259412,133780,476,1450072,22220604
2024-11-20 03:01:19,1858332,39236,576,194016,15132,990696,365880,946176,315524,44520,50356,520908,349340,1259920,133956,476,1450072,22220584
2024-11-20 03:01:21,1858332,39192,576,194016,15132,990904,365880,946384,315524,44520,50356,520908,349340,1260340,133844,476,1450072,22220628
2024-11-20 03:01:24,1858332,38876,576,194016,15132,990992,365880,946472,315524,44520,50356,520908,349340,1260220,133772,476,1450072,22220604
2024-11-20 03:01:26,1858332,38724,576,194016,15132,991232,365880,946712,315524,44520,50356,520908,349340,1260712,133760,476,1450072,22220512
2024-11-20 03:01:29,1858332,38316,576,194016,15132,991292,365880,946772,315524,44520,50356,520908,349340,1260492,133772,476,1450072,22220748
2024-11-20 03:01:31,1858332,38040,576,194016,15132,991644,365880,947124,315524,44520,50356,520908,349340,1260780,133824,476,1450072,22220760
2024-11-20 03:01:34,1858332,37612,576,194016,15132,992040,365880,947520,315524,44520,50356,520908,349340,1261524,133772,476,1450072,22220744
2024-11-20 03:01:37,1858332,37144,576,194016,15132,992948,365880,948428,315524,44520,50356,520908,349340,1262248,133780,476,1450072,22220660
2024-11-20 03:01:39,1858332,42368,576,194016,15108,987332,365904,942812,315548,44520,50356,520908,349400,1256836,133088,476,1450072,22220608
2024-11-20 03:01:42,1858332,42428,576,194016,15108,987644,365904,943124,315548,44520,50356,520908,349400,1257024,133108,476,1450072,22220760
2024-11-20 03:01:45,1858332,42468,576,194016,15104,987724,365904,943204,315548,44520,50356,520908,349404,1257072,133028,476,1450072,22220620
2024-11-20 03:01:47,1858332,41884,576,194016,15104,987992,365904,943472,315548,44520,50356,520908,349404,1257152,133028,476,1450072,22212460
2024-11-20 03:01:50,1858332,41992,576,194016,15104,988120,365900,943600,315544,44520,50356,520908,349404,1257404,133128,476,1450072,22220592
2024-11-20 03:01:53,1858332,41776,576,194016,15104,988360,365900,943840,315544,44520,50356,520908,349404,1257756,133032,476,1450072,22212536
2024-11-20 03:01:55,1858332,41596,576,194016,15104,988444,365900,943924,315544,44520,50356,520908,349404,1257772,133124,476,1450072,22220724
2024-11-20 03:01:58,1858332,41160,576,194016,15104,988556,365900,944036,315544,44520,50356,520908,349404,1258100,133032,476,1450072,22220656
2024-11-20 03:02:00,1858332,41188,576,194016,15104,988716,365900,944196,315544,44520,50356,520908,349404,1258124,132848,476,1450072,22220604
2024-11-20 03:02:03,1858332,40740,576,194016,15104,988844,365900,944324,315544,44520,50356,520908,349404,1258176,133032,476,1450072,22220688
2024-11-20 03:02:06,1858332,40440,576,194016,15104,989236,365900,944716,315544,44520,50356,520908,349404,1258456,133032,476,1450072,22220668
2024-11-20 03:02:08,1858332,40436,576,194016,15104,989596,365920,945076,315564,44520,50356,520908,349424,1258964,133112,476,1450072,22220668
2024-11-20 03:02:10,1858332,40376,576,194016,15104,989580,365920,945060,315564,44520,50356,520908,349424,1258988,133040,476,1450072,22220644
2024-11-20 03:02:13,1858332,40216,576,194016,15104,989672,365920,945152,315564,44520,50356,520908,349424,1259072,133024,476,1450072,22220684
2024-11-20 03:02:16,1858332,39720,576,194016,15104,989928,365920,945408,315564,44520,50356,520908,349424,1259020,133040,476,1450072,22220804
2024-11-20 03:02:18,1858332,39400,576,194016,15104,990016,365920,945496,315564,44520,50356,520908,349424,1259568,133088,476,1450072,22220724
2024-11-20 03:02:21,1858332,39404,576,194016,15104,990256,365920,945736,315564,44520,50356,520908,349424,1259576,133128,476,1450072,22220576
2024-11-20 03:02:24,1858332,39012,576,194016,15104,990428,365920,945908,315564,44520,50356,520908,349424,1259784,132856,476,1450072,22220756
2024-11-20 03:02:26,1858332,39228,576,194016,15104,990372,365920,945852,315564,44520,50356,520908,349424,1259904,133268,476,1450072,22220608
2024-11-20 03:02:29,1858332,39104,576,194016,15104,990804,365920,946284,315564,44520,50356,520908,349424,1259916,133224,476,1450072,22212420
2024-11-20 03:02:31,1858332,38748,576,194016,15104,990996,365920,946476,315564,44520,50356,520908,349424,1260288,132924,476,1450072,22220744
2024-11-20 03:02:34,1858332,40240,576,191676,15104,991768,362700,946616,315316,45152,47384,520908,349192,1260012,133052,476,1450072,22220848
2024-11-20 03:02:36,1858332,41136,576,191676,15104,991992,362700,946840,315316,45152,47384,520908,349192,1260256,133040,476,1450072,22220620
2024-11-20 03:02:39,1858332,40672,576,191676,15104,992164,362700,947012,315316,45152,47384,520908,349192,1260592,132952,476,1450072,22220588
2024-11-20 03:02:42,1858332,40872,576,191676,15100,992416,362704,947264,315320,45152,47384,520908,349200,1260984,133040,476,1450072,22220552
2024-11-20 03:02:44,1858332,40584,576,191676,15100,992444,362704,947292,315320,45152,47384,520908,349200,1261028,133076,476,1450072,22220656
2024-11-20 03:02:47,1858332,40592,576,191676,15100,992464,362704,947312,315320,45152,47384,520908,349200,1260828,133224,476,1450072,22220676
2024-11-20 03:02:49,1858332,40484,576,191676,15100,992600,362704,947448,315320,45152,47384,520908,349200,1261264,133040,476,1450072,22220724
2024-11-20 03:02:52,1858332,40028,576,191676,15100,993004,362704,947852,315320,45152,47384,520908,349200,1261448,133092,476,1450072,22220648
2024-11-20 03:02:55,1858332,39784,576,191676,15100,993176,362704,948024,315320,45152,47384,520908,349200,1261728,133224,476,1450072,22220576
2024-11-20 03:02:57,1858332,39632,576,191676,15100,993348,362680,948196,315296,45152,47384,520908,349200,1261804,133032,476,1450072,22220848
2024-11-20 03:03:00,1858332,39248,576,191676,15100,993316,362680,948164,315296,45152,47384,520908,349200,1261568,133040,476,1450072,22220712
2024-11-20 03:03:02,1858332,38936,576,191676,15100,993564,362680,948412,315296,45152,47384,520908,349200,1261976,133296,476,1450072,22220812
2024-11-20 03:03:05,1858332,38712,576,191676,15100,994056,362680,948904,315296,45152,47384,520908,349200,1262440,133120,476,1450072,22220816
2024-11-20 03:03:08,1858332,45680,576,191676,15100,986956,362688,941804,315304,45152,47384,520908,349332,1255768,133224,476,1450072,22220592
2024-11-20 03:03:10,1858332,45324,576,191676,15100,987568,362688,942416,315304,45152,47384,520908,349332,1255936,133288,476,1450072,22220800
2024-11-20 03:03:13,1858332,45408,576,191676,15100,987724,362688,942572,315304,45152,47384,520908,349332,1256184,133112,476,1450072,22220532
2024-11-20 03:03:15,1858332,44980,576,191676,15100,987704,362688,942552,315304,45152,47384,520908,349332,1256240,133040,476,1450072,22220660
2024-11-20 03:03:18,1858332,44628,576,191860,15100,987940,362812,942788,315304,45152,47508,520908,349332,1256428,133092,476,1450072,22220636
2024-11-20 03:03:21,1858332,42808,612,193388,15304,990584,362276,945368,313268,45216,49008,520908,349620,1256740,133736,536,1450072,22220656
2024-11-20 03:03:23,1858332,42608,612,193388,15304,990612,362276,945396,313268,45216,49008,520908,349620,1256948,133552,536,1450072,22220600
2024-11-20 03:03:26,1858332,42400,612,193388,15304,991004,362276,945788,313268,45216,49008,520908,349620,1257280,133736,536,1450072,22220616
2024-11-20 03:03:29,1858332,41696,620,193420,15296,991508,362320,946292,313280,45216,49040,520908,349652,1257724,133560,536,1450072,22220600
2024-11-20 03:03:31,1858332,41304,620,193420,15296,991788,362332,946572,313284,45216,49048,520908,349652,1258060,133612,536,1450072,22220624
2024-11-20 03:03:34,1858332,41348,628,193420,15296,991940,362340,946724,313284,45216,49056,520908,349652,1258212,133704,536,1450072,22220640
2024-11-20 03:03:36,1858332,40852,628,193420,15296,991984,362340,946768,313284,45216,49056,520908,349652,1258212,133560,536,1450072,22212588
2024-11-20 03:03:39,1858332,40568,644,193424,15316,992308,362384,947092,313308,45216,49076,520908,349656,1258536,133812,536,1450072,22220608
2024-11-20 03:03:42,1858332,40516,644,193424,15316,992316,362384,947100,313308,45216,49076,520908,349656,1258636,133760,536,1450072,22220840
2024-11-20 03:03:44,1858332,40084,644,193424,15316,992860,362388,947644,313312,45216,49076,520908,349660,1259332,133664,536,1450072,22220708
2024-11-20 03:03:47,1858332,40072,644,193424,15316,993312,362388,948096,313312,45216,49076,520908,349660,1259880,133576,536,1450072,22220772
2024-11-20 03:03:50,1858332,39400,644,193424,15316,993640,362388,948424,313312,45216,49076,520908,349660,1259932,133760,536,1450072,22220656
2024-11-20 03:03:52,1858332,39056,644,193424,15316,993840,362388,948624,313312,45216,49076,520908,349660,1260144,133748,536,1450072,22220644
2024-11-20 03:03:55,1858332,39440,644,193428,15312,994000,362388,948784,313312,45216,49076,520908,349680,1260344,133760,536,1450072,22220640
2024-11-20 03:03:57,1858332,38748,644,193424,15312,994220,362400,949004,313324,45216,49076,520908,349680,1260764,133768,536,1450072,22212628
2024-11-20 03:04:00,1858332,38212,644,193424,15312,994508,362400,949292,313324,45216,49076,520908,349680,1260856,133400,536,1450072,22220728
2024-11-20 03:04:02,1858332,38408,644,193424,15312,994760,362400,949544,313324,45216,49076,520908,349680,1261092,133792,536,1450072,22220640
2024-11-20 03:04:05,1858332,38416,644,193424,15312,994780,362400,949564,313324,45216,49076,520908,349680,1261236,133584,536,1450072,22220472
2024-11-20 03:04:07,1858332,38044,644,193424,15312,994756,362400,949540,313324,45216,49076,520908,349680,1261032,133820,536,1450072,22220712
2024-11-20 03:04:10,1858332,38028,644,193424,15312,995012,362400,949796,313324,45216,49076,520908,349680,1261564,133768,536,1450072,22220680
2024-11-20 03:04:12,1858332,37796,644,193424,15312,994932,362404,949716,313328,45216,49076,520908,349684,1261452,133584,536,1450072,22220696
2024-11-20 03:04:15,1858332,36992,644,193424,15312,995860,362408,950644,313332,45216,49076,520908,349688,1262160,133772,536,1450072,22220704
2024-11-20 03:04:18,1858332,36848,644,193424,15312,996240,362408,951024,313332,45216,49076,520908,349688,1262808,133776,536,1450072,22220696
2024-11-20 03:04:20,1858332,41780,644,193424,15356,990868,362472,945652,313396,45216,49076,520908,350048,1257200,133776,536,1450072,22220608
2024-11-20 03:04:23,1858332,41836,644,193424,15356,990804,362472,945588,313396,45216,49076,520908,350048,1257268,133776,536,1450072,22220744
2024-11-20 03:04:25,1858332,41628,644,193424,15356,990916,362472,945700,313396,45216,49076,520908,350048,1257388,133776,536,1450072,22220880
2024-11-20 03:04:28,1858332,41332,644,193424,15356,991064,362476,945848,313400,45216,49076,520908,350052,1257504,133776,536,1450072,22220736
2024-11-20 03:04:30,1858332,41152,644,193424,15356,991460,362476,946244,313400,45216,49076,520908,350052,1257776,133592,536,1450072,22220844
2024-11-20 03:04:33,1858332,41152,644,193424,15356,991500,362476,946284,313400,45216,49076,520908,350052,1257876,133720,536,1450072,22220832
2024-11-20 03:04:35,1858332,41072,644,193424,15356,991508,362476,946292,313400,45216,49076,520908,350052,1257820,133776,536,1450072,22220584
2024-11-20 03:04:38,1858332,40956,644,193424,15356,991796,362484,946580,313408,45216,49076,520908,350060,1258440,133636,536,1450072,22220628
2024-11-20 03:04:41,1858332,40864,644,193424,15352,991916,362484,946700,313408,45216,49076,520908,350064,1258420,133780,536,1450072,22220824
2024-11-20 03:04:43,1858332,40288,644,193424,15352,992272,362484,947056,313408,45216,49076,520908,350064,1258788,133832,536,1450072,22220652
2024-11-20 03:04:46,1858332,40252,644,193424,15352,992644,362484,947428,313408,45216,49076,520908,350064,1259180,133804,536,1450072,22220676
2024-11-20 03:04:48,1858332,40236,644,193424,15352,992416,362488,947200,313412,45216,49076,520908,350068,1258784,133780,536,1450072,22220628
2024-11-20 03:04:51,1858332,39840,644,193424,15352,992812,362488,947596,313412,45216,49076,520908,350068,1259200,133804,536,1450072,22220712
2024-11-20 03:04:54,1858332,39964,644,193424,15352,992744,362488,947528,313412,45216,49076,520908,350068,1259164,133780,536,1450072,22220488
2024-11-20 03:04:57,1858332,39752,644,193424,15352,993072,362492,947856,313416,45216,49076,520908,350072,1259756,133780,536,1450072,22220564
2024-11-20 03:04:59,1858332,39196,644,193424,15352,993436,362492,948220,313416,45216,49076,520908,350076,1259996,133800,536,1450072,22220644
2024-11-20 03:05:02,1858332,39264,644,193424,15352,993872,362496,948656,313420,45216,49076,520908,350076,1260336,133808,536,1450072,22220704
2024-11-20 03:05:05,1858332,39028,644,193424,15352,994168,362496,948952,313420,45216,49076,520908,350076,1260568,133600,536,1450072,22220772
2024-11-20 03:05:07,1858332,38752,644,193424,15352,994424,362500,949208,313424,45216,49076,520908,350080,1260932,133808,536,1450072,22220792
2024-11-20 03:05:10,1858332,38188,644,193428,15348,995224,362500,950008,313424,45216,49076,520908,350116,1261740,133600,536,1450072,22220696
2024-11-20 03:05:12,1858332,38272,644,193424,15348,995156,362492,949940,313416,45216,49076,520908,350116,1261688,133784,536,1450072,22220652
2024-11-20 03:05:15,1858332,37788,644,193424,15348,995572,362492,950356,313416,45216,49076,520908,350116,1261800,133784,536,1450072,22220844
2024-11-20 03:05:17,1858332,37864,644,193424,15348,995740,362492,950524,313416,45216,49076,520908,350116,1262128,133784,536,1450072,22220768
2024-11-20 03:05:19,1858332,37752,644,193424,15348,995928,362492,950712,313416,45216,49076,520908,350116,1262256,133600,536,1450072,22220700
2024-11-20 03:05:22,1858332,42160,552,190756,15348,991232,362224,945892,315980,45340,46244,520908,349804,1260092,131944,536,1450072,20300656
2024-11-20 03:05:24,1858332,39948,552,190768,15348,993976,362200,948636,315996,45340,46204,520908,349812,1262868,133672,536,1450072,22220752
2024-11-20 03:05:27,1858332,39816,552,190768,15348,993924,362200,948584,315996,45340,46204,520908,349812,1262820,133696,536,1450072,22220708
2024-11-20 03:05:30,1858332,38972,552,190768,15348,994540,362200,949200,315996,45340,46204,520908,349812,1263488,133760,536,1450072,22220732
2024-11-20 03:05:32,1858332,45852,552,190768,15348,987452,362200,942112,315996,45340,46204,520908,349812,1256432,133608,536,1450072,22220864
2024-11-20 03:05:35,1858332,45696,552,190768,15348,987664,362200,942324,315996,45340,46204,520908,349816,1256684,133776,536,1450072,22220768
2024-11-20 03:05:37,1858332,45616,552,190768,15348,987696,362204,942356,316000,45340,46204,520908,349816,1256644,133776,536,1450072,22212668
2024-11-20 03:05:40,1858332,45136,560,190760,15348,988616,362204,943276,316000,45340,46204,520908,349844,1257384,133776,536,1450072,22220652
2024-11-20 03:05:42,1858332,44900,560,190784,15348,988208,362252,942864,316028,45344,46224,520908,349852,1257304,133784,536,1450072,22220536
2024-11-20 03:05:45,1858332,44624,568,190780,15348,988624,362252,943280,316028,45344,46224,520908,349852,1257468,133732,536,1450072,22220820
2024-11-20 03:05:47,1858332,44616,568,190784,15352,988652,362276,943308,316052,45344,46224,520908,349872,1257776,133784,536,1450072,22220804
2024-11-20 03:05:50,1858332,44644,568,190784,15352,988852,362284,943508,316052,45344,46232,520908,349872,1257868,133784,536,1450072,22220648
2024-11-20 03:05:52,1858332,44284,568,190784,15352,988868,362284,943524,316052,45344,46232,520908,349872,1257884,133784,536,1450072,22220584
2024-11-20 03:05:55,1858332,44536,568,190784,15352,989116,362284,943772,316052,45344,46232,520908,349872,1258052,133724,536,1450072,22220484
2024-11-20 03:05:58,1858332,44344,568,190784,15352,989460,362288,944116,316056,45344,46232,520908,349876,1258364,133768,536,1450072,22220772
2024-11-20 03:06:01,1858332,44008,568,190716,15420,989860,362288,944516,316056,45344,46232,520908,349908,1258668,133600,536,1450072,22220680
2024-11-20 03:06:03,1858332,43664,568,190784,15408,989892,362436,944548,316204,45344,46232,520908,349968,1259000,133836,536,1450072,22220524
2024-11-20 03:06:06,1858332,43516,568,190784,15408,989828,362436,944484,316204,45344,46232,520908,349968,1258956,133600,536,1450072,22220732
2024-11-20 03:06:08,1858332,43284,568,190784,15408,990248,362436,944904,316204,45344,46232,520908,349968,1259180,133804,536,1450072,22220596
2024-11-20 03:06:11,1858332,40844,568,193092,15412,990368,364772,945024,316232,45344,48540,520908,349992,1259496,133876,536,1450072,22220624
2024-11-20 03:06:14,1858332,40572,568,193092,15412,990400,364772,945056,316232,45344,48540,520908,349992,1259528,133852,536,1450072,22220656
2024-11-20 03:06:16,1858332,40468,568,193092,15412,990856,364772,945512,316232,45344,48540,520908,349992,1259956,133872,536,1450072,22220744
2024-11-20 03:06:19,1858332,39864,568,193092,15412,990932,364772,945588,316232,45344,48540,520908,349992,1259984,133852,536,1450072,22220808
2024-11-20 03:06:21,1858332,39700,568,193092,15412,991076,364772,945732,316232,45344,48540,520908,349992,1260348,133720,536,1450072,22220720
2024-11-20 03:06:24,1858332,39780,568,193092,15412,990996,364772,945652,316232,45344,48540,520908,349992,1260292,133852,536,1450072,22220640
2024-11-20 03:06:26,1858332,39604,568,193092,15412,991360,364772,946016,316232,45344,48540,520908,349992,1260424,133900,536,1450072,22220788
2024-11-20 03:06:29,1858332,39120,568,193092,15412,991504,364772,946160,316232,45344,48540,520908,349992,1260636,133856,536,1450072,22220696
2024-11-20 03:06:31,1858332,38548,568,193092,15412,991980,364772,946636,316232,45344,48540,520908,349992,1260932,133876,536,1450072,22220612
2024-11-20 03:06:34,1858332,38572,568,193092,15412,992140,364772,946796,316232,45344,48540,520908,349992,1261248,133856,536,1450072,22220736
2024-11-20 03:06:36,1858332,38408,568,193092,15412,992364,364772,947020,316232,45344,48540,520908,349992,1261572,133672,536,1450072,22220848
2024-11-20 03:06:39,1858332,38152,568,193092,15412,992548,364772,947204,316232,45344,48540,520908,349992,1261612,133868,536,1450072,22220684
2024-11-20 03:06:42,1858332,37648,568,193092,15412,992772,364772,947428,316232,45344,48540,520908,349992,1262060,134040,536,1450072,22220788
2024-11-20 03:06:45,1858332,37520,568,193092,15412,992964,364772,947620,316232,45344,48540,520908,349992,1262172,133856,536,1450072,22220700
2024-11-20 03:06:47,1858332,37316,568,193092,15412,993388,364772,948044,316232,45344,48540,520908,349992,1262460,133896,536,1450072,22220668
2024-11-20 03:06:50,1858332,38068,568,191988,15412,993896,363364,948428,316156,45468,47208,520908,349928,1262768,133856,536,1450072,22220832
2024-11-20 03:06:52,1858332,45008,568,191880,15408,987232,363280,941680,316160,45552,47120,520908,349936,1255904,133908,536,1450072,22220796
2024-11-20 03:06:55,1858332,44968,568,191880,15408,987156,363280,941604,316160,45552,47120,520908,349936,1255932,133796,536,1450072,22220508
2024-11-20 03:06:58,1858332,44360,568,191880,15408,987412,363280,941860,316160,45552,47120,520908,349936,1256144,133856,536,1450072,22220688
2024-11-20 03:07:01,1858332,44708,568,191880,15408,987188,363280,941636,316160,45552,47120,520908,349936,1256168,133672,536,1450072,22220764
2024-11-20 03:07:03,1858332,44924,568,191880,15408,987776,363280,942224,316160,45552,47120,520908,349936,1256604,133880,536,1450072,22220816
2024-11-20 03:07:06,1858332,44456,568,191880,15408,988216,363280,942664,316160,45552,47120,520908,349936,1257116,133856,536,1450072,22220772
2024-11-20 03:07:08,1858332,43924,568,191880,15408,988136,363280,942584,316160,45552,47120,520908,349936,1257212,133876,536,1450072,22220868
2024-11-20 03:07:11,1858332,43984,568,191880,15408,988756,363280,943204,316160,45552,47120,520908,349936,1257588,133880,536,1450072,22220604
2024-11-20 03:07:13,1858332,43780,568,191880,15408,988532,363280,942980,316160,45552,47120,520908,349936,1257392,133856,536,1450072,22220700
2024-11-20 03:07:16,1858332,43996,568,191880,15408,988908,363280,943356,316160,45552,47120,520908,349936,1257756,133940,536,1450072,22220672
2024-11-20 03:07:19,1858332,43564,568,191880,15408,988712,363280,943160,316160,45552,47120,520908,349936,1257756,133672,536,1450072,22220640
2024-11-20 03:07:21,1858332,43456,568,191880,15408,989272,363280,943720,316160,45552,47120,520908,349936,1258096,133908,536,1450072,22220528
2024-11-20 03:07:24,1858332,43336,568,191880,15408,989476,363280,943924,316160,45552,47120,520908,349936,1258304,133856,536,1450072,22220636
2024-11-20 03:07:26,1858332,43112,568,191880,15408,989456,363280,943904,316160,45552,47120,520908,349936,1258804,133856,536,1450072,22220736
2024-11-20 03:07:29,1858332,42964,568,191880,15408,989796,363280,944244,316160,45552,47120,520908,349936,1258672,133880,536,1450072,22220764
2024-11-20 03:07:31,1858332,42792,568,191880,15408,989976,363280,944424,316160,45552,47120,520908,349936,1258704,133856,536,1450072,22212644
2024-11-20 03:07:34,1858332,41480,572,192316,15384,991080,363136,945328,315776,45752,47360,520908,349832,1259288,133912,536,1450072,22220744
2024-11-20 03:07:37,1858332,41632,564,193336,15412,990684,363788,945052,315296,45632,48492,520908,349924,1258304,132872,536,1450072,22211912
2024-11-20 03:07:39,1858332,39348,564,193336,15412,992692,363792,947060,315300,45632,48492,520908,349928,1260588,134232,536,1450072,22220760
2024-11-20 03:07:42,1858332,38532,564,193336,15412,993212,363792,947580,315300,45632,48492,520908,349928,1261332,134228,536,1450072,22220680
2024-11-20 03:07:44,1858332,38248,564,193336,15412,993912,363780,948280,315288,45632,48492,520908,349932,1261820,134200,536,1450072,22220740
2024-11-20 03:07:47,1858332,43288,564,193336,15412,988596,363780,942964,315288,45632,48492,520908,349952,1256416,134272,536,1450072,22220700
2024-11-20 03:07:50,1858332,43428,564,193336,15412,988684,363780,943052,315288,45632,48492,520908,349952,1256676,134332,536,1450072,22220540
2024-11-20 03:07:52,1858332,43744,564,193336,15412,988188,363784,942556,315292,45632,48492,520908,349968,1256268,134332,536,1450072,22220636
2024-11-20 03:07:55,1858332,43116,564,193336,15412,988640,363784,943008,315292,45632,48492,520908,349968,1256696,134312,536,1450072,22220744
2024-11-20 03:07:58,1858332,43008,564,193336,15412,988840,363784,943208,315292,45632,48492,520908,349968,1256644,134512,536,1450072,22220708
2024-11-20 03:08:00,1858332,42664,564,193336,15412,989060,363784,943428,315292,45632,48492,520908,349968,1257404,134328,536,1450072,22220652
2024-11-20 03:08:03,1858332,42648,564,193336,15412,989504,363784,943872,315292,45632,48492,520908,349968,1257352,134328,536,1450072,22212508
2024-11-20 03:08:06,1858332,42604,564,193336,15412,989520,363784,943888,315292,45632,48492,520908,349968,1257656,134328,536,1450072,22220740
2024-11-20 03:08:08,1858332,42648,564,193336,15412,989428,363792,943796,315300,45632,48492,520908,349976,1257148,134340,536,1450072,22212516
2024-11-20 03:08:11,1858332,42188,564,193336,15412,989784,363796,944152,315304,45632,48492,520908,349980,1257480,134332,536,1450072,22220812
2024-11-20 03:08:13,1858332,41964,564,193336,15412,989956,363796,944324,315304,45632,48492,520908,349980,1257976,134332,536,1450072,22212512
2024-11-20 03:08:16,1858332,42016,564,193336,15412,989956,363796,944324,315304,45632,48492,520908,349980,1257980,134332,536,1450072,22220620
2024-11-20 03:08:18,1858332,41472,564,193336,15412,990092,363796,944460,315304,45632,48492,520908,349980,1258044,134332,536,1450072,22220592
2024-11-20 03:08:21,1858332,41460,564,193336,15412,990532,363796,944900,315304,45632,48492,520908,349980,1258348,134332,536,1450072,22220736
2024-11-20 03:08:23,1858332,41132,564,193336,15412,990464,363796,944832,315304,45632,48492,520908,349980,1258400,134376,536,1450072,22220716
2024-11-20 03:08:26,1858332,41252,564,193336,15412,990728,363796,945096,315304,45632,48492,520908,349980,1258824,134148,536,1450072,22220760
2024-11-20 03:08:29,1858332,40676,564,193336,15412,990992,363796,945360,315304,45632,48492,520908,349980,1259008,134332,536,1450072,22220580
2024-11-20 03:08:31,1858332,40364,564,193336,15412,991124,363796,945492,315304,45632,48492,520908,349980,1258980,134192,536,1450072,22220828
2024-11-20 03:08:34,1858332,40336,564,193336,15412,991152,363796,945520,315304,45632,48492,520908,349980,1258936,134332,536,1450072,22220584
2024-11-20 03:08:36,1858332,40320,564,193336,15412,991672,363796,946040,315304,45632,48492,520908,349980,1259504,134332,536,1450072,22220620
2024-11-20 03:08:39,1858332,39180,564,190728,15420,994292,361664,948484,315956,45808,45708,520908,349780,1261108,136224,536,1450072,24142104
2024-11-20 03:08:42,1858332,40320,556,188656,15204,992964,361272,947768,317036,45196,44236,520908,350132,1263544,137292,536,1450072,24140996
2024-11-20 03:08:44,1858332,42472,576,188288,15172,992088,360944,946896,317056,45192,43888,520908,349780,1262404,137088,536,1450072,22221888
2024-11-20 03:08:47,1858332,44180,540,186656,15172,991412,359032,945712,317312,45700,41720,520908,349800,1260564,134432,536,1450072,25895160
2024-11-20 03:08:50,1858332,32840,556,192548,15176,996980,364900,951240,317352,45740,47548,520908,349812,1267212,139304,536,1450072,24141752
2024-11-20 03:08:53,1858332,47096,556,187432,15176,991192,357832,945404,315408,45788,42424,520908,348004,1259460,134420,536,1450072,22221500
2024-11-20 03:08:56,1858332,38364,568,188880,15176,997608,359476,951820,315592,45788,43884,520908,348232,1265972,137944,536,1450072,24141836
2024-11-20 03:08:58,1858332,36556,576,191492,15172,993940,363888,948504,317124,45436,46764,520908,347984,1263896,139464,536,1450072,24142944
2024-11-20 03:09:01,1858332,43032,584,192660,15176,989620,364024,943556,316628,46064,47396,520908,347632,1258760,133404,536,1450072,20300384
2024-11-20 03:09:04,1858332,49704,584,192660,15176,982608,364032,936544,316628,46064,47404,520908,347672,1251644,132628,536,1450072,20300460
2024-11-20 03:09:06,1858332,49324,592,192660,15176,983092,364040,937028,316628,46064,47412,520908,347672,1252048,132628,536,1450072,20300296
2024-11-20 03:09:09,1858332,46752,592,193088,15176,984512,364468,938448,316628,46064,47840,520908,347672,1253628,134116,536,1450072,22220700
2024-11-20 03:09:12,1858332,46652,592,193088,15176,984400,364468,938336,316628,46064,47840,520908,347672,1253480,134172,536,1450072,22220560
2024-11-20 03:09:14,1858332,46852,592,193088,15176,984568,364468,938504,316628,46064,47840,520908,347672,1253524,134280,536,1450072,22220608
2024-11-20 03:09:17,1858332,46628,592,193088,15176,984836,364468,938772,316628,46064,47840,520908,347672,1253900,134308,536,1450072,22220704
2024-11-20 03:09:20,1858332,37644,600,193620,15164,991664,365268,945600,316872,46064,48396,520908,347944,1260988,137864,536,1450072,26062032
2024-11-20 03:09:22,1858332,40224,576,191468,15168,991800,362576,945636,316532,46164,46044,520908,347780,1260616,139220,536,1450072,24141768
2024-11-20 03:09:25,1858332,37292,692,193148,15168,993844,363896,947132,316544,46712,47352,520908,347792,1262256,140108,536,1450072,24141800
2024-11-20 03:09:28,1858332,36580,692,193992,15168,993472,364740,946760,316544,46712,48196,520908,347792,1261844,140068,536,1450072,24141712
2024-11-20 03:09:30,1858332,36296,700,193992,15168,993816,364752,947104,316548,46712,48204,520908,347816,1262084,140064,536,1450072,24141632
2024-11-20 03:09:33,1858332,45696,672,191384,15168,987880,361764,941448,315916,46432,45848,520908,347636,1253988,133328,536,1450072,22220756
2024-11-20 03:09:36,1858332,48236,672,191384,15168,986116,361764,939684,315916,46432,45848,520908,347636,1253908,133212,536,1450072,20300328
2024-11-20 03:09:38,1858332,48004,672,191384,15168,986364,361764,939932,315916,46432,45848,520908,347636,1254304,133400,536,1450072,20300448
2024-11-20 03:09:41,1858332,48004,672,191384,15168,986388,361764,939956,315916,46432,45848,520908,347636,1254348,133396,536,1450072,20300260
2024-11-20 03:09:43,1858332,48364,672,191384,15168,986664,361764,940232,315916,46432,45848,520908,347636,1254616,133440,536,1450072,20300400
2024-11-20 03:09:46,1858332,48516,672,191384,15168,986672,361768,940240,315920,46432,45848,520908,347640,1254636,133580,536,1450072,20300328
2024-11-20 03:09:48,1858332,48108,672,191384,15168,986724,361768,940292,315920,46432,45848,520908,347640,1254728,133264,536,1450072,20300376
2024-11-20 03:09:51,1858332,47220,672,191384,15168,986996,361768,940564,315920,46432,45848,520908,347640,1254920,133396,536,1450072,20300524
2024-11-20 03:09:53,1858332,47636,672,191384,15168,987264,361768,940832,315920,46432,45848,520908,347640,1255376,133212,536,1450072,20300436
2024-11-20 03:09:56,1858332,47556,672,191384,15168,987584,361768,941152,315920,46432,45848,520908,347640,1255456,133440,536,1450072,20300468
2024-11-20 03:09:59,1858332,42432,596,195864,15128,990280,363860,943296,314164,46984,49696,520908,347184,1256020,133652,536,1450072,20300448
2024-11-20 03:10:01,1858332,42372,596,195864,15128,990500,363864,943516,314164,46984,49700,520908,347184,1256252,133856,536,1450072,20300440
2024-11-20 03:10:04,1858332,42248,596,195864,15128,990900,363864,943916,314164,46984,49700,520908,347184,1256384,133864,536,1450072,20300404
2024-11-20 03:10:07,1858332,42104,596,195864,15128,990960,363864,943976,314164,46984,49700,520908,347184,1256780,133836,536,1450072,20300484
2024-11-20 03:10:09,1858332,41760,596,195864,15128,991408,363864,944424,314164,46984,49700,520908,347184,1256988,133872,536,1450072,20300448
2024-11-20 03:10:12,1858332,41032,596,195864,15128,992420,363864,945436,314164,46984,49700,520908,347184,1257896,133836,536,1450072,20300460
2024-11-20 03:10:14,1858332,46580,596,195864,15128,986100,363864,939116,314164,46984,49700,520908,347184,1251584,133136,536,1450072,20300480
2024-11-20 03:10:17,1858332,46412,596,195864,15128,986952,363864,939968,314164,46984,49700,520908,347184,1252668,133084,536,1450072,20300356
2024-11-20 03:10:19,1858332,45280,596,195864,15128,987584,363864,940600,314164,46984,49700,520908,347184,1253316,133084,536,1450072,20300416
2024-11-20 03:10:22,1858332,45080,596,195864,15128,987644,363864,940660,314164,46984,49700,520908,347184,1253188,133084,536,1450072,20300324
2024-11-20 03:10:24,1858332,44892,596,195864,15128,988032,363864,941048,314164,46984,49700,520908,347184,1253716,133084,536,1450072,20300340
2024-11-20 03:10:26,1858332,44408,596,195864,15128,988308,363864,941324,314164,46984,49700,520908,347184,1253924,133084,536,1450072,20300440
2024-11-20 03:10:29,1858332,44352,596,195864,15128,988576,363864,941592,314164,46984,49700,520908,347184,1254336,133108,536,1450072,20300504
2024-11-20 03:10:31,1858332,44340,596,195864,15128,988536,363864,941552,314164,46984,49700,520908,347184,1254316,132900,536,1450072,20300528
2024-11-20 03:10:34,1858332,43156,596,195864,15128,989468,363864,942484,314164,46984,49700,520908,347184,1255068,133128,536,1450072,22219964
2024-11-20 03:10:37,1858332,37632,600,193292,15124,994168,362896,947180,315812,46988,47084,520908,346828,1261604,137736,536,1450072,24141652
2024-11-20 03:10:40,1858332,40472,612,187596,15124,993012,360688,947504,317900,45508,42788,520908,346004,1256600,135688,540,1450072,24142884
2024-11-20 03:10:43,1858332,50848,612,187552,15120,984512,360648,938892,317880,45620,42768,520908,346028,1255332,133604,536,1450072,20300444
2024-11-20 03:10:45,1858332,48460,620,187552,15120,986812,360652,941192,317884,45620,42768,520908,346060,1257436,135052,536,1450072,22220480
2024-11-20 03:10:48,1858332,48344,620,187552,15120,986908,360668,941284,317896,45624,42772,520908,346064,1257580,135152,536,1450072,22220572
2024-11-20 03:10:51,1858332,47916,620,187552,15120,987196,360668,941572,317896,45624,42772,520908,346064,1257976,135408,536,1450072,22220748
2024-11-20 03:10:54,1858332,48008,620,187552,15120,987348,360668,941724,317896,45624,42772,520908,346064,1258208,135208,536,1450072,22220708
2024-11-20 03:10:57,1858332,47580,620,187552,15120,987716,360672,942092,317900,45624,42772,520908,346068,1258384,135392,536,1450072,22220868
2024-11-20 03:10:59,1858332,46980,620,187552,15120,988352,360676,942728,317904,45624,42772,520908,346072,1259084,135444,536,1450072,22220804
2024-11-20 03:11:02,1858332,52516,628,187560,15120,982196,360700,936564,317920,45632,42780,520908,346088,1253036,134644,536,1450072,22220648
2024-11-20 03:11:04,1858332,52732,628,187560,15120,982488,360700,936856,317920,45632,42780,520908,346088,1253336,134828,536,1450072,22220664
2024-11-20 03:11:07,1858332,52312,636,187560,15120,983012,360700,937372,317920,45640,42780,520908,346088,1253844,134708,536,1450072,22220732
2024-11-20 03:11:10,1858332,52828,636,187560,15120,982052,360700,936412,317920,45640,42780,520908,346088,1252804,134668,536,1450072,22220608
2024-11-20 03:11:13,1858332,51516,636,189212,15120,981796,362324,936156,317920,45640,44404,520908,346088,1252408,134652,536,1450072,22220688
2024-11-20 03:11:15,1858332,51324,636,189212,15120,982044,362352,936404,317920,45640,44432,520908,346088,1252936,134676,536,1450072,22220532
2024-11-20 03:11:17,1858332,51344,636,189212,15120,982056,362356,936416,317924,45640,44432,520908,346092,1252740,134652,536,1450072,22220712
2024-11-20 03:11:20,1858332,51280,636,189212,15120,982184,362356,936544,317924,45640,44432,520908,346092,1253088,134656,536,1450072,22220744
2024-11-20 03:11:23,1858332,51464,636,189212,15120,982036,362360,936396,317928,45640,44432,520908,346096,1252860,134468,536,1450072,22220720
2024-11-20 03:11:25,1858332,51076,636,189212,15112,982432,362360,936792,317928,45640,44432,520908,346104,1253144,134696,536,1450072,22220664
2024-11-20 03:11:28,1858332,50784,636,189212,15112,982820,362360,937180,317928,45640,44432,520908,346104,1253572,134596,536,1450072,22220592
2024-11-20 03:11:31,1858332,50896,636,189212,15112,982912,362360,937272,317928,45640,44432,520908,346104,1253788,134468,536,1450072,22220700
2024-11-20 03:11:33,1858332,50416,636,189212,15112,982840,362360,937200,317928,45640,44432,520908,346104,1253924,134516,536,1450072,22220740
2024-11-20 03:11:36,1858332,50000,636,189212,15112,983212,362360,937572,317928,45640,44432,520908,346104,1254076,134652,536,1450072,22220784
2024-11-20 03:11:38,1858332,50176,636,189212,15112,983344,362360,937704,317928,45640,44432,520908,346104,1254228,134652,536,1450072,22220760
2024-11-20 03:11:41,1858332,50164,636,189212,15112,983632,362360,937992,317928,45640,44432,520908,346104,1254556,134596,536,1450072,22220884
2024-11-20 03:11:44,1858332,49624,636,189212,15112,983608,362360,937968,317928,45640,44432,520908,346104,1254724,134652,536,1450072,22220772
2024-11-20 03:11:46,1858332,49236,636,189212,15112,984080,362360,938440,317928,45640,44432,520908,346104,1254936,134652,536,1450072,22220748
2024-11-20 03:11:49,1858332,48608,636,189212,15112,984348,362360,938708,317928,45640,44432,520908,346104,1255300,134676,536,1450072,22220712
2024-11-20 03:11:52,1858332,48988,636,189212,15112,984416,362360,938776,317928,45640,44432,520908,346104,1255260,134652,536,1450072,22220604
2024-11-20 03:11:54,1858332,48792,636,189212,15112,984584,362360,938944,317928,45640,44432,520908,346104,1255436,134696,536,1450072,22220780
2024-11-20 03:11:57,1858332,48976,636,189212,15112,984604,362360,938964,317928,45640,44432,520908,346104,1255684,134652,536,1450072,22220728
2024-11-20 03:12:00,1858332,47848,636,189212,15112,985500,362364,939860,317932,45640,44432,520908,346108,1256528,134652,536,1450072,22220696
2024-11-20 03:12:02,1858332,47380,636,189212,15112,985932,362364,940292,317932,45640,44432,520908,346108,1256824,134488,536,1450072,22220648
2024-11-20 03:12:05,1858332,47532,636,189212,15112,985848,362364,940208,317932,45640,44432,520908,346108,1256836,134652,536,1450072,22220684
2024-11-20 03:12:07,1858332,46972,636,189212,15112,986328,362364,940688,317932,45640,44432,520908,346108,1257116,134652,536,1450072,22220588
2024-11-20 03:12:10,1858332,47144,636,189212,15112,986308,362364,940668,317932,45640,44432,520908,346108,1257064,134584,536,1450072,22220756
2024-11-20 03:12:13,1858332,46580,636,189212,15112,986768,362364,941128,317932,45640,44432,520908,346108,1257488,134652,536,1450072,22220700
2024-11-20 03:12:16,1858332,46348,636,189212,15112,986984,362364,941344,317932,45640,44432,520908,346108,1258000,134468,536,1450072,22220776
2024-11-20 03:12:18,1858332,46420,636,189212,15112,986920,362364,941280,317932,45640,44432,520908,346108,1257780,134656,536,1450072,22220856
2024-11-20 03:12:21,1858332,46428,636,189212,15112,987072,362364,941432,317932,45640,44432,520908,346108,1257720,134676,536,1450072,22220552
2024-11-20 03:12:24,1858332,46196,636,189212,15112,987124,362364,941484,317932,45640,44432,520908,346108,1258124,134652,536,1450072,22212388
2024-11-20 03:12:26,1858332,46168,636,189212,15112,987244,362364,941604,317932,45640,44432,520908,346108,1258116,134696,536,1450072,22220552
2024-11-20 03:12:29,1858332,45764,636,189212,15112,987792,362364,942152,317932,45640,44432,520908,346108,1258636,134652,536,1450072,22212520
2024-11-20 03:12:31,1858332,50780,664,190196,15112,981172,363360,935532,317928,45640,45432,520908,346108,1252068,134652,536,1450072,22220780
2024-11-20 03:12:34,1858332,50744,664,190196,15112,981504,363372,935864,317928,45640,45444,520908,346108,1252244,134568,536,1450072,22220792
2024-11-20 03:12:37,1858332,50912,664,190196,15112,981332,363372,935692,317928,45640,45444,520908,346108,1252184,134652,536,1450072,22220752
2024-11-20 03:12:39,1858332,50628,664,190196,15112,981736,363372,936096,317928,45640,45444,520908,346108,1252204,134704,536,1450072,22220724
2024-11-20 03:12:42,1858332,50536,664,190196,15112,981652,363372,936012,317928,45640,45444,520908,346108,1252420,134652,536,1450072,22220604
2024-11-20 03:12:44,1858332,50228,664,190196,15112,981664,363372,936024,317928,45640,45444,520908,346108,1252696,134704,536,1450072,22220676
2024-11-20 03:12:47,1858332,49628,664,190196,15112,982420,363372,936780,317928,45640,45444,520908,346108,1253196,134676,536,1450072,22220768
2024-11-20 03:12:50,1858332,49528,664,190196,15108,982572,363372,936932,317928,45640,45444,520908,346112,1253612,134652,536,1450072,22220568
2024-11-20 03:12:52,1858332,49652,664,190196,15108,982992,363372,937352,317928,45640,45444,520908,346112,1253856,134664,536,1450072,22220604
2024-11-20 03:12:55,1858332,48528,664,190196,15108,983936,363372,938296,317928,45640,45444,520908,346112,1254864,134596,536,1450072,22220516
2024-11-20 03:12:57,1858332,48232,664,190196,15108,984012,363372,938372,317928,45640,45444,520908,346112,1254920,134652,536,1450072,22220752
2024-11-20 03:13:00,1858332,47232,664,190196,15108,984868,363376,939228,317932,45640,45444,520908,346116,1255708,134616,536,1450072,22220728
2024-11-20 03:13:03,1858332,46796,664,190196,15108,985220,363376,939580,317932,45640,45444,520908,346116,1255836,134656,536,1450072,22220780
2024-11-20 03:13:05,1858332,47216,664,190196,15108,985324,363376,939684,317932,45640,45444,520908,346116,1256148,134524,536,1450072,22220532
2024-11-20 03:13:08,1858332,46492,664,190196,15108,985592,363376,939952,317932,45640,45444,520908,346116,1256396,134680,536,1450072,22220596
2024-11-20 03:13:11,1858332,46676,664,190196,15108,985512,363376,939872,317932,45640,45444,520908,346116,1256000,134656,536,1450072,22220640
2024-11-20 03:13:13,1858332,46276,664,190196,15108,986000,363376,940360,317932,45640,45444,520908,346116,1256736,134524,536,1450072,22220796
2024-11-20 03:13:16,1858332,46112,664,190196,15108,985968,363376,940328,317932,45640,45444,520908,346116,1256864,134656,536,1450072,22220724
2024-11-20 03:13:18,1858332,45936,664,190196,15108,986248,363376,940608,317932,45640,45444,520908,346116,1257008,134524,536,1450072,22220744
2024-11-20 03:13:21,1858332,45976,664,190196,15108,986280,363376,940640,317932,45640,45444,520908,346116,1256944,134472,536,1450072,22220704
2024-11-20 03:13:23,1858332,45360,664,190196,15108,986428,363408,940788,317964,45640,45444,520908,346148,1257252,134656,536,1450072,22220732
2024-11-20 03:13:26,1858332,45156,664,190196,15108,986452,363408,940812,317964,45640,45444,520908,346148,1257428,134668,536,1450072,22220768
2024-11-20 03:13:28,1858332,45292,664,190196,15108,986696,363408,941056,317964,45640,45444,520908,346148,1257420,134656,536,1450072,22220656
2024-11-20 03:13:31,1858332,44992,664,190196,15108,987008,363408,941368,317964,45640,45444,520908,346148,1257840,134496,536,1450072,22220644
2024-11-20 03:13:34,1858332,44908,664,190196,15108,987068,363408,941428,317964,45640,45444,520908,346148,1257920,134656,536,1450072,22220680
2024-11-20 03:13:36,1858332,44620,664,190196,15108,987428,363408,941788,317964,45640,45444,520908,346148,1258164,134524,536,1450072,22220676
2024-11-20 03:13:39,1858332,44760,664,190196,15108,987324,363408,941684,317964,45640,45444,520908,346148,1258268,134664,536,1450072,22220868
2024-11-20 03:13:42,1858332,44776,664,190196,15108,987416,363408,941776,317964,45640,45444,520908,346148,1258112,134656,536,1450072,22220684
2024-11-20 03:13:44,1858332,44160,664,190196,15108,987664,363408,942024,317964,45640,45444,520908,346148,1258604,134496,536,1450072,22220536
2024-11-20 03:13:47,1858332,49856,664,190196,15108,981784,363408,936144,317964,45640,45444,520908,346148,1252548,134684,536,1450072,22220556
2024-11-20 03:13:50,1858332,49848,664,190196,15108,981736,363408,936096,317964,45640,45444,520908,346148,1252576,134660,536,1450072,22220584
2024-11-20 03:13:52,1858332,49668,664,190196,15108,981964,363408,936324,317964,45640,45444,520908,346148,1252760,134720,536,1450072,22220748
2024-11-20 03:13:55,1858332,49956,664,190196,15108,981884,363408,936244,317964,45640,45444,520908,346148,1252552,134476,536,1450072,22220752
2024-11-20 03:13:57,1858332,49748,664,190196,15108,982216,363408,936576,317964,45640,45444,520908,346160,1252952,134712,536,1450072,22220760
2024-11-20 03:14:00,1858332,49128,664,190196,15108,983064,363408,937424,317964,45640,45444,520908,346160,1253880,134600,536,1450072,22220632
2024-11-20 03:14:02,1858332,48820,664,190196,15108,983080,363408,937440,317964,45640,45444,520908,346160,1254128,134660,536,1450072,22220752
2024-11-20 03:14:05,1858332,48724,664,190196,15108,983688,363408,938048,317964,45640,45444,520908,346160,1254392,134604,536,1450072,22220856
2024-11-20 03:14:08,1858332,48172,664,190196,15108,984036,363412,938396,317968,45640,45444,520908,346164,1254752,134480,536,1450072,22220700
2024-11-20 03:14:10,1858332,48208,664,190196,15108,983736,363412,938096,317968,45640,45444,520908,346164,1254624,134708,536,1450072,22220760
2024-11-20 03:14:13,1858332,47752,664,190196,15108,984120,363412,938480,317968,45640,45444,520908,346164,1255016,134480,536,1450072,22220892
2024-11-20 03:14:16,1858332,47580,664,190196,15108,984220,363412,938580,317968,45640,45444,520908,346164,1255152,134532,536,1450072,22220708
2024-11-20 03:14:18,1858332,47520,664,190196,15108,984768,363412,939128,317968,45640,45444,520908,346164,1255588,134708,536,1450072,22220688
2024-11-20 03:14:21,1858332,47324,664,190196,15108,984664,363412,939024,317968,45640,45444,520908,346164,1255580,134480,536,1450072,22220516
2024-11-20 03:14:23,1858332,47564,664,190196,15108,984912,363412,939272,317968,45640,45444,520908,346164,1255708,134532,536,1450072,22220644
2024-11-20 03:14:26,1858332,47200,664,190196,15108,984932,363412,939292,317968,45640,45444,520908,346164,1255708,134688,536,1450072,22220704
2024-11-20 03:14:29,1858332,47312,664,190196,15108,984856,363412,939216,317968,45640,45444,520908,346164,1255680,134664,536,1450072,22220584
2024-11-20 03:14:31,1858332,46792,664,190196,15108,985512,363416,939872,317972,45640,45444,520908,346168,1256252,134716,536,1450072,22220820
2024-11-20 03:14:34,1858332,46584,664,190196,15108,985452,363416,939812,317972,45640,45444,520908,346168,1256600,134664,536,1450072,22220556
2024-11-20 03:14:36,1858332,46252,664,190196,15108,985440,363416,939800,317972,45640,45444,520908,346168,1256408,134664,536,1450072,22220732
2024-11-20 03:14:39,1858332,46192,664,190196,15108,986064,363416,940424,317972,45640,45444,520908,346168,1256884,134688,536,1450072,22220616
2024-11-20 03:14:42,1858332,46276,664,190196,15108,985792,363416,940152,317972,45640,45444,520908,346168,1256708,134664,536,1450072,22220548
2024-11-20 03:14:44,1858332,45804,664,190196,15108,985976,363416,940336,317972,45640,45444,520908,346168,1256820,134480,536,1450072,22220532
2024-11-20 03:14:46,1858332,45744,664,190196,15108,986152,363416,940512,317972,45640,45444,520908,346168,1257048,134664,536,1450072,22220760
2024-11-20 03:14:49,1858332,45488,664,190196,15108,986584,363416,940944,317972,45640,45444,520908,346168,1257376,134708,536,1450072,22220600
2024-11-20 03:14:52,1858332,45260,664,190196,15108,986552,363416,940912,317972,45640,45444,520908,346168,1257576,134664,536,1450072,22220848
2024-11-20 03:14:54,1858332,45060,664,190196,15108,986928,363416,941288,317972,45640,45444,520908,346168,1257612,134668,536,1450072,22220856
2024-11-20 03:14:57,1858332,45244,664,190196,15108,987004,363416,941364,317972,45640,45444,520908,346168,1257928,134688,536,1450072,22220604
2024-11-20 03:15:00,1858332,44892,664,190196,15108,987148,363416,941508,317972,45640,45444,520908,346168,1257996,134664,536,1450072,22220712
2024-11-20 03:15:02,1858332,44736,664,190196,15108,987668,363416,942028,317972,45640,45444,520908,346552,1258376,134664,536,1450072,22220672
2024-11-20 03:15:05,1858332,44324,664,190196,15108,988200,363416,942560,317972,45640,45444,520908,346552,1258972,134604,536,1450072,22220716
2024-11-20 03:15:08,1858332,44192,664,190196,15108,987924,363416,942284,317972,45640,45444,520908,346552,1258816,134664,536,1450072,22220776
2024-11-20 03:15:11,1858332,43712,664,190196,15108,988564,363416,942924,317972,45640,45444,520908,346552,1259460,134664,536,1450072,22220676
2024-11-20 03:15:13,1858332,50324,664,190196,15108,981652,363420,936012,317976,45640,45444,520908,346556,1252376,134664,536,1450072,22220784
2024-11-20 03:15:16,1858332,50076,664,190196,15108,981880,363420,936240,317976,45640,45444,520908,346556,1252708,134664,536,1450072,22220840
2024-11-20 03:15:18,1858332,50004,664,190196,15108,981964,363420,936324,317976,45640,45444,520908,346556,1252828,134664,536,1450072,22220696
2024-11-20 03:15:21,1858332,49652,664,190196,15108,982388,363420,936748,317976,45640,45444,520908,346556,1253256,134664,536,1450072,22220696
2024-11-20 03:15:23,1858332,49364,664,190196,15108,983028,363420,937388,317976,45640,45444,520908,346556,1253820,134664,536,1450072,22220580
2024-11-20 03:15:26,1858332,49044,664,190196,15108,983060,363420,937420,317976,45640,45444,520908,346556,1253988,134712,536,1450072,22220680
2024-11-20 03:15:29,1858332,48452,664,190196,15108,983352,363420,937712,317976,45640,45444,520908,346556,1254252,134480,536,1450072,22220720
2024-11-20 03:15:31,1858332,44080,672,190192,15108,987964,363368,942232,318012,45732,45356,520908,346636,1258940,137604,536,1450072,24141944
2024-11-20 03:15:34,1858332,33708,656,187820,15092,998072,360972,953372,317708,44700,43264,520908,346324,1258920,136772,536,1450072,26063056
2024-11-20 03:15:37,1858332,52248,664,185496,14680,983808,359308,940704,316028,43104,43280,520908,345744,1255324,135184,536,1450072,22220416
2024-11-20 03:15:40,1858332,51148,664,185504,14676,984432,359328,941328,316040,43104,43288,520908,345760,1255752,135112,536,1450072,22220844
2024-11-20 03:15:42,1858332,51296,664,185504,14676,984764,359328,941660,316040,43104,43288,520908,345760,1256252,135384,536,1450072,22220580
2024-11-20 03:15:45,1858332,51092,664,185504,14676,984924,359328,941820,316040,43104,43288,520908,345760,1256456,135208,536,1450072,22220600
2024-11-20 03:15:47,1858332,50880,664,185504,14672,985252,359328,942148,316040,43104,43288,520908,345764,1256664,135212,536,1450072,22220664
2024-11-20 03:15:50,1858332,50660,664,185504,14672,985604,359328,942500,316040,43104,43288,520908,345764,1257176,135340,536,1450072,22220572
2024-11-20 03:15:52,1858332,50816,664,185504,14672,985512,359328,942408,316040,43104,43288,520908,345764,1256968,135408,536,1450072,22220596
2024-11-20 03:15:55,1858332,50480,664,185504,14672,985996,359328,942892,316040,43104,43288,520908,345764,1257420,135432,536,1450072,22220668
2024-11-20 03:15:58,1858332,50488,664,185504,14672,986128,359328,943024,316040,43104,43288,520908,345764,1257500,135408,536,1450072,22220740
2024-11-20 03:16:00,1858332,49896,664,185504,14672,986476,359328,943372,316040,43104,43288,520908,345764,1257932,135428,536,1450072,22220740
2024-11-20 03:16:03,1858332,49388,664,185504,14672,986992,359328,943888,316040,43104,43288,520908,345764,1258520,135408,536,1450072,22220740
2024-11-20 03:16:05,1858332,55632,664,185504,14672,980420,359328,937316,316040,43104,43288,520908,345764,1251864,134744,536,1450072,22220832
2024-11-20 03:16:08,1858332,55904,664,185504,14672,980076,359328,936972,316040,43104,43288,520908,345764,1251640,134668,536,1450072,22220712
2024-11-20 03:16:10,1858332,56084,664,185504,14672,980152,359328,937048,316040,43104,43288,520908,345764,1251728,134688,536,1450072,22220700
2024-11-20 03:16:13,1858332,55952,664,185504,14672,980576,359324,937472,316036,43104,43288,520908,345764,1252024,134692,536,1450072,22220800
2024-11-20 03:16:16,1858332,55764,664,185504,14672,980600,359324,937496,316036,43104,43288,520908,345764,1252260,134668,536,1450072,22220708
2024-11-20 03:16:18,1858332,55452,664,185504,14672,980872,359328,937768,316040,43104,43288,520908,345768,1252524,134668,536,1450072,22220680
2024-11-20 03:16:21,1858332,55252,664,185504,14672,981096,359328,937992,316040,43104,43288,520908,345780,1252532,134668,536,1450072,22220488
2024-11-20 03:16:23,1858332,55276,664,185504,14672,981192,359340,938088,316052,43104,43288,520908,345780,1252864,134536,536,1450072,22220708
2024-11-20 03:16:26,1858332,55232,664,185504,14672,981300,359340,938196,316052,43104,43288,520908,345780,1252684,134484,536,1450072,22220764
2024-11-20 03:16:28,1858332,55292,664,185504,14672,981388,359340,938284,316052,43104,43288,520908,345780,1252876,134484,536,1450072,22220544
2024-11-20 03:16:31,1858332,54988,664,185504,14672,981608,359344,938504,316056,43104,43288,520908,345784,1253168,134668,536,1450072,22220632
2024-11-20 03:16:33,1858332,54556,664,185504,14672,981972,359344,938868,316056,43104,43288,520908,345784,1253292,134704,536,1450072,22220744
2024-11-20 03:16:36,1858332,54544,664,185504,14672,982036,359344,938932,316056,43104,43288,520908,345784,1253548,134692,536,1450072,22220696
2024-11-20 03:16:39,1858332,54496,664,185504,14672,981976,359344,938872,316056,43104,43288,520908,345784,1253336,134484,536,1450072,22220756
2024-11-20 03:16:41,1858332,54300,664,185504,14672,982284,359344,939180,316056,43104,43288,520908,345784,1253604,134672,536,1450072,22220728
2024-11-20 03:16:44,1858332,53868,664,185504,14672,982524,359344,939420,316056,43104,43288,520908,345784,1253968,134672,536,1450072,22220700
2024-11-20 03:16:47,1858332,53848,664,185504,14672,982544,359344,939440,316056,43104,43288,520908,345784,1254248,134668,536,1450072,22220596
2024-11-20 03:16:49,1858332,53744,664,185504,14672,982936,359344,939832,316056,43104,43288,520908,345784,1254384,134536,536,1450072,22220572
2024-11-20 03:16:52,1858332,53440,664,185504,14672,983192,359344,940088,316056,43104,43288,520908,345784,1254564,134592,536,1450072,22220676
2024-11-20 03:16:55,1858332,53632,664,185504,14672,983152,359344,940048,316056,43104,43288,520908,345784,1254624,134668,536,1450072,22220516
2024-11-20 03:16:57,1858332,53032,664,185504,14672,983364,359360,940260,316072,43104,43288,520908,345800,1254740,134780,536,1450072,22220624
2024-11-20 03:17:00,1858332,52440,704,185520,14672,983600,359380,940496,316072,43104,43308,520908,345800,1255092,134668,536,1450072,22220500
2024-11-20 03:17:03,1858332,52724,704,185520,14672,983664,359412,940556,316072,43108,43340,520908,345800,1255364,134484,536,1450072,22220608
2024-11-20 03:17:05,1858332,52260,712,185520,14672,984232,359420,941124,316072,43108,43348,520908,345800,1255652,134692,536,1450072,22220640
2024-11-20 03:17:08,1858332,51980,712,185520,14672,984536,359420,941428,316072,43108,43348,520908,345800,1255896,134672,536,1450072,22220748
2024-11-20 03:17:10,1858332,51736,712,185520,14672,984468,359420,941360,316072,43108,43348,520908,345800,1255872,134724,536,1450072,22220696
2024-11-20 03:17:13,1858332,51516,712,185520,14672,984732,359420,941624,316072,43108,43348,520908,345800,1256180,134672,536,1450072,22220700
2024-11-20 03:17:15,1858332,51156,712,185520,14672,985012,359420,941904,316072,43108,43348,520908,345800,1256440,134672,536,1450072,22220664
2024-11-20 03:17:18,1858332,51104,712,185520,14672,985300,359420,942192,316072,43108,43348,520908,345800,1256864,134720,536,1450072,22220556
2024-11-20 03:17:21,1858332,50920,712,185520,14672,985432,359420,942324,316072,43108,43348,520908,345800,1256976,134672,536,1450072,22220736
2024-11-20 03:17:23,1858332,50860,712,185520,14672,986064,359420,942956,316072,43108,43348,520908,345800,1257596,134724,536,1450072,22220820
2024-11-20 03:17:26,1858332,50376,712,185520,14672,986072,359420,942964,316072,43108,43348,520908,345800,1257716,134488,536,1450072,22220676
2024-11-20 03:17:28,1858332,50120,712,185520,14672,986316,359420,943208,316072,43108,43348,520908,345800,1257564,134724,536,1450072,22220784
2024-11-20 03:17:31,1858332,49868,712,185520,14672,986628,359420,943520,316072,43108,43348,520908,345800,1258060,134584,536,1450072,22220740
2024-11-20 03:17:33,1858332,56460,712,185520,14672,979664,359420,936556,316072,43108,43348,520908,345800,1251412,134672,536,1450072,22220808
2024-11-20 03:17:36,1858332,55772,712,185520,14672,980364,359420,937256,316072,43108,43348,520908,345800,1251892,134696,536,1450072,22220740
2024-11-20 03:17:39,1858332,55720,712,185520,14672,980268,359420,937160,316072,43108,43348,520908,345800,1251684,134672,536,1450072,22220624
2024-11-20 03:17:41,1858332,55764,740,185532,14668,980840,359456,937728,316072,43112,43384,520908,345832,1252448,134696,536,1450072,22220760
2024-11-20 03:17:44,1858332,55572,768,185576,14668,981344,359520,938228,316068,43116,43452,520908,345832,1252896,134700,536,1450072,22220876
2024-11-20 03:17:46,1858332,55320,768,185576,14668,981504,359520,938388,316068,43116,43452,520908,345832,1252824,134676,536,1450072,22220676
2024-11-20 03:17:49,1858332,54912,776,185576,14668,981924,359528,938808,316068,43116,43460,520908,345832,1253384,134696,536,1450072,22220692
2024-11-20 03:17:52,1858332,54748,776,185576,14668,982000,359528,938884,316068,43116,43460,520908,345832,1253660,134676,536,1450072,22220696
2024-11-20 03:17:54,1858332,54436,776,185576,14668,981984,359528,938868,316068,43116,43460,520908,345832,1253568,134728,536,1450072,22220788
2024-11-20 03:17:57,1858332,53880,776,185576,14668,982708,359532,939592,316072,43116,43460,520908,345836,1254176,134700,536,1450072,22220684
2024-11-20 03:18:00,1858332,53644,776,185576,14668,982492,359536,939376,316076,43116,43460,520908,345840,1253876,134676,536,1450072,22220796
2024-11-20 03:18:02,1858332,53300,776,185576,14668,982640,359536,939524,316076,43116,43460,520908,345840,1254160,134492,536,1450072,22220752
2024-11-20 03:18:05,1858332,53804,776,185576,14668,982796,359536,939680,316076,43116,43460,520908,345840,1254400,134676,536,1450072,22220616
2024-11-20 03:18:08,1858332,53312,776,185576,14668,983312,359536,940196,316076,43116,43460,520908,345840,1254716,134676,536,1450072,22220676
2024-11-20 03:18:10,1858332,52900,776,185576,14668,983640,359536,940524,316076,43116,43460,520908,345840,1255036,134720,536,1450072,22220608
2024-11-20 03:18:13,1858332,53032,776,185576,14668,983508,359536,940392,316076,43116,43460,520908,345840,1254988,134676,536,1450072,22220488
2024-11-20 03:18:15,1858332,51632,776,185576,14668,984444,359536,941328,316076,43116,43460,520908,345840,1255824,134676,536,1450072,22220660
2024-11-20 03:18:18,1858332,51632,776,185576,14668,984396,359536,941280,316076,43116,43460,520908,345840,1255796,134700,536,1450072,22220812
2024-11-20 03:18:21,1858332,51664,776,185576,14668,985084,359536,941968,316076,43116,43460,520908,345840,1256760,134492,536,1450072,22220720
2024-11-20 03:18:23,1858332,50776,776,185576,14668,985380,359536,942264,316076,43116,43460,520908,345840,1256860,134676,536,1450072,22220724
2024-11-20 03:18:26,1858332,50468,776,185576,14668,985196,359536,942080,316076,43116,43460,520908,345840,1256720,134676,536,1450072,22220692
2024-11-20 03:18:28,1858332,50444,776,185576,14668,985660,359536,942544,316076,43116,43460,520908,345840,1257160,134508,536,1450072,22220824
2024-11-20 03:18:31,1858332,50284,776,185576,14668,985656,359536,942540,316076,43116,43460,520908,345840,1257208,134676,536,1450072,22220732
2024-11-20 03:18:33,1858332,50800,776,185576,14668,985776,359536,942660,316076,43116,43460,520908,345840,1257100,134728,536,1450072,22220568
2024-11-20 03:18:36,1858332,49792,776,185576,14668,986484,359536,943368,316076,43116,43460,520908,345840,1258024,134600,536,1450072,22220712
2024-11-20 03:18:38,1858332,56400,776,185576,14668,980000,359536,936884,316076,43116,43460,520908,345860,1251596,134492,536,1450072,22220700
2024-11-20 03:18:41,1858332,55904,776,185576,14668,980528,359536,937412,316076,43116,43460,520908,345860,1252228,134728,536,1450072,22220684
2024-11-20 03:18:44,1858332,55544,776,185576,14668,980732,359536,937616,316076,43116,43460,520908,345860,1252216,134496,536,1450072,22220896
2024-11-20 03:18:47,1858332,55468,776,185576,14668,981108,359536,937992,316076,43116,43460,520908,345860,1252540,134496,536,1450072,22220852
2024-11-20 03:18:49,1858332,55040,776,185576,14668,981428,359536,938312,316076,43116,43460,520908,345860,1252908,134704,536,1450072,22220552
2024-11-20 03:18:51,1858332,54984,776,185576,14668,981532,359536,938416,316076,43116,43460,520908,345860,1253092,134496,536,1450072,22220660
2024-11-20 03:18:54,1858332,55300,776,185576,14668,981608,359536,938492,316076,43116,43460,520908,345860,1253144,134708,536,1450072,22220788
2024-11-20 03:18:56,1858332,54544,776,185576,14668,981864,359536,938748,316076,43116,43460,520908,345860,1253144,134680,536,1450072,22220820
2024-11-20 03:18:59,1858332,54488,776,185576,14672,981956,359544,938840,316084,43116,43460,520908,345864,1253600,134728,536,1450072,22220688
2024-11-20 03:19:02,1858332,54152,776,185576,14672,982224,359544,939108,316084,43116,43460,520908,345864,1253752,134680,536,1450072,22220820
2024-11-20 03:19:04,1858332,53952,776,185576,14672,982284,359544,939168,316084,43116,43460,520908,345864,1253832,134680,536,1450072,22220832
2024-11-20 03:19:07,1858332,53452,776,185576,14672,982736,359544,939620,316084,43116,43460,520908,345864,1254128,134496,536,1450072,22220624
2024-11-20 03:19:09,1858332,53812,776,185576,14672,982588,359544,939472,316084,43116,43460,520908,345864,1254236,134548,536,1450072,22220660
2024-11-20 03:19:12,1858332,53332,776,185576,14672,982928,359544,939812,316084,43116,43460,520908,345864,1254372,134680,536,1450072,22220656
2024-11-20 03:19:14,1858332,53260,776,185576,14672,983072,359544,939956,316084,43116,43460,520908,345864,1254532,134916,536,1450072,22220800
2024-11-20 03:19:17,1858332,53200,776,185576,14672,983200,359544,940084,316084,43116,43460,520908,345864,1254908,134680,536,1450072,22220664
2024-11-20 03:19:19,1858332,52844,776,185576,14672,983292,359544,940176,316084,43116,43460,520908,345864,1254916,134712,536,1450072,22220712
2024-11-20 03:19:22,1858332,52532,776,185576,14672,983912,359544,940796,316084,43116,43460,520908,345864,1255320,134708,536,1450072,22220792
2024-11-20 03:19:25,1858332,52648,776,185576,14672,983920,359544,940804,316084,43116,43460,520908,345864,1255468,134684,536,1450072,22220604
2024-11-20 03:19:27,1858332,52064,776,185576,14672,984320,359544,941204,316084,43116,43460,520908,345864,1255784,134544,536,1450072,22220772
2024-11-20 03:19:30,1858332,52260,776,185576,14672,984068,359544,940952,316084,43116,43460,520908,345864,1255556,134684,536,1450072,22220704
2024-11-20 03:19:32,1858332,51928,776,185576,14672,984528,359544,941412,316084,43116,43460,520908,345864,1255976,134684,536,1450072,22220724
2024-11-20 03:19:35,1858332,52028,776,185576,14672,984396,359544,941280,316084,43116,43460,520908,345864,1255956,134704,536,1450072,22220716
2024-11-20 03:19:38,1858332,51564,776,185576,14672,984652,359544,941536,316084,43116,43460,520908,345864,1256468,134500,536,1450072,22220840
2024-11-20 03:19:40,1858332,51456,776,185576,14672,985056,359544,941940,316084,43116,43460,520908,345864,1256728,134500,536,1450072,22220868
2024-11-20 03:19:43,1858332,51324,776,185576,14672,985292,359544,942176,316084,43116,43460,520908,345864,1256692,134628,536,1450072,22220632
2024-11-20 03:19:46,1858332,49684,776,186860,14676,985308,360784,942192,316084,43116,44700,520908,345864,1256916,134684,536,1450072,22220884
2024-11-20 03:19:48,1858332,49580,776,186824,14676,985364,360796,942248,316088,43116,44708,520908,345864,1256876,134624,536,1450072,22220708
2024-11-20 03:19:51,1858332,49636,776,186824,14676,985712,360796,942596,316088,43116,44708,520908,345864,1257272,134580,536,1450072,22220600
2024-11-20 03:19:53,1858332,49320,776,186824,14676,985560,360796,942444,316088,43116,44708,520908,345864,1257288,134784,536,1450072,22220556
2024-11-20 03:19:56,1858332,48720,776,186824,14676,986224,360796,943108,316088,43116,44708,520908,345864,1257656,134788,536,1450072,22220676
2024-11-20 03:19:59,1858332,48660,776,186824,14676,986184,360796,943068,316088,43116,44708,520908,345864,1257560,134580,536,1450072,22220784
2024-11-20 03:20:01,1858332,48772,776,186824,14676,986528,360796,943412,316088,43116,44708,520908,345864,1258180,134816,536,1450072,22220784
2024-11-20 03:20:04,1858332,54288,776,186824,14676,980324,360792,937208,316084,43116,44708,520908,346012,1251652,134788,536,1450072,22220600
2024-11-20 03:20:07,1858332,54324,776,186824,14676,980356,360792,937240,316084,43116,44708,520908,346012,1252044,134580,536,1450072,22220692
2024-11-20 03:20:09,1858332,54076,776,186824,14676,980496,360796,937380,316088,43116,44708,520908,346016,1251860,134816,536,1450072,22220780
2024-11-20 03:20:12,1858332,54192,776,186824,14676,980736,360796,937620,316088,43116,44708,520908,346016,1252264,134764,536,1450072,22220592
2024-11-20 03:20:14,1858332,53632,776,186824,14676,981116,360796,938000,316088,43116,44708,520908,346016,1252600,134816,536,1450072,22220516
2024-11-20 03:20:17,1858332,53736,776,186824,14676,981052,360796,937936,316088,43116,44708,520908,346016,1252544,134764,536,1450072,22220716
2024-11-20 03:20:19,1858332,53392,776,186824,14676,981072,360804,937956,316096,43116,44708,520908,346024,1252668,134816,536,1450072,22220840
2024-11-20 03:20:22,1858332,53296,776,186824,14676,981348,360804,938232,316096,43116,44708,520908,346024,1253052,134764,536,1450072,22220740
2024-11-20 03:20:24,1858332,52836,776,186824,14676,982008,360804,938892,316096,43116,44708,520908,346024,1253656,134816,536,1450072,22220800
2024-11-20 03:20:27,1858332,42200,768,196840,14792,983604,369348,940424,314696,43180,54652,520908,345472,1253624,135584,536,1450072,22220684
2024-11-20 03:20:29,1858332,42288,768,196840,14792,983928,369348,940748,314696,43180,54652,520908,345472,1253868,135560,536,1450072,22220720
2024-11-20 03:20:32,1858332,42084,768,196840,14792,984352,369348,941172,314696,43180,54652,520908,345472,1254412,135500,536,1450072,22220676
2024-11-20 03:20:34,1858332,42252,768,196848,14784,984380,369472,941200,314820,43180,54652,520908,345724,1254560,135560,536,1450072,22220844
2024-11-20 03:20:37,1858332,41760,768,196840,14784,984284,369516,941104,314864,43180,54652,520908,345724,1254404,135512,536,1450072,22220676
2024-11-20 03:20:40,1858332,41048,768,196840,14784,985124,369516,941944,314864,43180,54652,520908,345724,1255168,135560,536,1450072,22220756
2024-11-20 03:20:42,1858332,40872,768,196840,14784,985356,369516,942176,314864,43180,54652,520908,345724,1255412,135612,536,1450072,22220624
2024-11-20 03:20:45,1858332,41012,768,196840,14784,985640,369516,942460,314864,43180,54652,520908,345724,1255740,135560,536,1450072,22220744
2024-11-20 03:20:47,1858332,40852,768,196840,14784,985528,369516,942348,314864,43180,54652,520908,345724,1255736,135612,536,1450072,22220636
2024-11-20 03:20:50,1858332,40440,768,196840,14784,985848,369516,942668,314864,43180,54652,520908,345724,1256120,135560,536,1450072,22220632
2024-11-20 03:20:52,1858332,40360,768,196840,14784,986028,369516,942848,314864,43180,54652,520908,345724,1256336,135552,536,1450072,22220796
2024-11-20 03:20:55,1858332,39492,768,196840,14784,986632,369516,943452,314864,43180,54652,520908,345724,1256688,135560,536,1450072,22220712
2024-11-20 03:20:57,1858332,39816,768,196840,14784,986944,369516,943764,314864,43180,54652,520908,345724,1257152,135560,536,1450072,22220612
2024-11-20 03:21:00,1858332,38716,768,196840,14784,987972,369516,944792,314864,43180,54652,520908,345724,1258148,135512,536,1450072,22220620
2024-11-20 03:21:03,1858332,38116,768,196840,14784,988460,369516,945280,314864,43180,54652,520908,345724,1258632,135560,536,1450072,22220708
2024-11-20 03:21:05,1858332,44608,768,196840,14784,981904,369516,938724,314864,43180,54652,520908,345724,1252060,135588,536,1450072,22220692
2024-11-20 03:21:08,1858332,44040,768,196840,14784,982020,369516,938840,314864,43180,54652,520908,345724,1252312,135560,536,1450072,22220584
2024-11-20 03:21:10,1858332,44100,768,196840,14784,982128,369516,938948,314864,43180,54652,520908,345724,1252292,135572,536,1450072,22220676
2024-11-20 03:21:13,1858332,43812,768,196840,14784,982240,369516,939060,314864,43180,54652,520908,345724,1252320,135560,536,1450072,22220696
2024-11-20 03:21:15,1858332,43740,768,196840,14784,982328,369516,939148,314864,43180,54652,520908,345724,1252404,135528,536,1450072,22220736
2024-11-20 03:21:18,1858332,43628,768,196840,14784,982720,369520,939540,314868,43180,54652,520908,345728,1252856,135376,536,1450072,22220824
2024-11-20 03:21:20,1858332,43452,768,196840,14784,983076,369520,939896,314868,43180,54652,520908,345728,1253276,135580,536,1450072,22212684
2024-11-20 03:21:23,1858332,43096,768,196840,14784,982900,369520,939720,314868,43180,54652,520908,345728,1253148,135376,536,1450072,22220700
2024-11-20 03:21:25,1858332,43092,768,196840,14784,983496,369520,940316,314868,43180,54652,520908,345728,1253620,135560,536,1450072,22220712
2024-11-20 03:21:28,1858332,42876,768,196840,14784,983548,369520,940368,314868,43180,54652,520908,345728,1253800,135376,536,1450072,22220700
2024-11-20 03:21:30,1858332,42700,768,196840,14784,984192,369520,941012,314868,43180,54652,520908,345728,1254276,135576,536,1450072,22220664
2024-11-20 03:21:33,1858332,42300,768,196840,14784,984404,369520,941224,314868,43180,54652,520908,345728,1254512,135560,536,1450072,22220568
2024-11-20 03:21:35,1858332,42008,768,196840,14784,984656,369548,941476,314896,43180,54652,520908,345756,1254936,135428,536,1450072,22220792
2024-11-20 03:21:38,1858332,41420,768,196840,14784,984636,369548,941456,314896,43180,54652,520908,345756,1255068,135560,536,1450072,22220800
2024-11-20 03:21:41,1858332,43112,768,196840,14784,983032,369548,939852,314896,43180,54652,520908,345756,1253408,135376,536,1450072,22220620
2024-11-20 03:21:43,1858332,41604,768,196840,14784,985160,369388,941820,314896,43340,54492,520908,345756,1255268,135504,536,1450072,22220708
2024-11-20 03:21:45,1858332,40936,768,196840,14784,985472,369388,942132,314896,43340,54492,520908,345756,1255424,135560,536,1450072,22220732
2024-11-20 03:21:48,1858332,40472,768,196840,14784,985820,369388,942480,314896,43340,54492,520908,345756,1255880,135572,536,1450072,22220624
2024-11-20 03:21:51,1858332,39976,768,196840,14784,986132,369388,942792,314896,43340,54492,520908,345756,1255960,135540,536,1450072,22220760
2024-11-20 03:21:53,1858332,40184,768,196840,14784,985952,369388,942612,314896,43340,54492,520908,345756,1255960,135580,536,1450072,22220560
2024-11-20 03:21:56,1858332,39960,768,196840,14784,986328,369388,942988,314896,43340,54492,520908,345756,1256584,135560,536,1450072,22220568
2024-11-20 03:21:58,1858332,39660,768,196840,14784,986396,369388,943056,314896,43340,54492,520908,345756,1256360,135560,536,1450072,22220504
2024-11-20 03:22:01,1858332,39636,776,196852,14784,986840,369408,943500,314896,43340,54512,520908,345756,1256888,135568,536,1450072,22220764
2024-11-20 03:22:03,1858332,39592,776,196852,14784,986948,369408,943608,314896,43340,54512,520908,345756,1256924,135572,536,1450072,22220696
2024-11-20 03:22:06,1858332,38844,784,196844,14784,987096,369408,943756,314896,43340,54512,520908,345756,1257292,135572,536,1450072,22220708
2024-11-20 03:22:08,1858332,41840,776,193916,14784,987308,366248,943968,314648,43340,51600,520908,345420,1257072,135572,536,1450072,22220636
2024-11-20 03:22:11,1858332,42124,776,193828,14784,987176,366024,943832,314540,43344,51484,520908,345420,1256900,135568,536,1450072,22220752
2024-11-20 03:22:13,1858332,41816,776,193828,14784,987524,366024,944180,314540,43344,51484,520908,345420,1257068,135436,536,1450072,22220760
2024-11-20 03:22:16,1858332,41696,776,193828,14784,987884,366024,944540,314540,43344,51484,520908,345420,1257644,135592,536,1450072,22220644
2024-11-20 03:22:18,1858332,41544,776,193828,14784,987820,366024,944476,314540,43344,51484,520908,345420,1257792,135568,536,1450072,22220676
2024-11-20 03:22:21,1858332,41060,776,193828,14784,988364,366024,945020,314540,43344,51484,520908,345420,1258112,135656,536,1450072,22220844
2024-11-20 03:22:24,1858332,40996,776,193828,14784,988416,366024,945072,314540,43344,51484,520908,345420,1257988,135512,536,1450072,22220748
2024-11-20 03:22:27,1858332,47548,776,193832,14780,981948,366024,938604,314540,43344,51484,520908,345428,1251640,135572,536,1450072,22220856
2024-11-20 03:22:29,1858332,47496,776,193828,14780,982620,366028,939276,314544,43344,51484,520908,345428,1252328,135576,536,1450072,22220728
2024-11-20 03:22:32,1858332,47356,776,193828,14780,982648,366028,939304,314544,43344,51484,520908,345428,1252384,135572,536,1450072,22220716
2024-11-20 03:22:34,1858332,47372,776,193828,14780,983000,366028,939656,314544,43344,51484,520908,345428,1252812,135432,536,1450072,22220608
2024-11-20 03:22:37,1858332,47032,776,193828,14780,983216,366028,939872,314544,43344,51484,520908,345428,1253076,135600,536,1450072,22220696
2024-11-20 03:22:39,1858332,47052,776,193828,14780,983364,366028,940020,314544,43344,51484,520908,345428,1253068,135572,536,1450072,22220680
2024-11-20 03:22:42,1858332,46876,776,193828,14780,983156,366028,939812,314544,43344,51484,520908,345428,1253072,135572,536,1450072,22220836
2024-11-20 03:22:45,1858332,46760,776,193828,14780,983284,366028,939940,314544,43344,51484,520908,345428,1253040,135388,536,1450072,22220692
2024-11-20 03:22:47,1858332,46612,776,193828,14780,983388,366028,940044,314544,43344,51484,520908,345428,1253068,135448,536,1450072,22220772
2024-11-20 03:22:50,1858332,46044,776,193828,14780,983824,366028,940480,314544,43344,51484,520908,345428,1253528,135572,536,1450072,22220696
2024-11-20 03:22:52,1858332,45648,776,193828,14780,984320,366028,940976,314544,43344,51484,520908,345428,1254120,135596,536,1450072,22220656
2024-11-20 03:22:55,1858332,45860,776,193828,14780,984256,366028,940912,314544,43344,51484,520908,345428,1254176,135576,536,1450072,22220696
2024-11-20 03:22:57,1858332,45708,776,193828,14780,984504,366032,941160,314548,43344,51484,520908,345432,1254244,135392,536,1450072,22220716
2024-11-20 03:23:00,1858332,45200,776,193824,14784,984852,366032,941508,314548,43344,51484,520908,345432,1254384,135576,536,1450072,22220812
2024-11-20 03:23:02,1858332,44996,776,193828,14784,985088,366036,941744,314552,43344,51484,520908,345432,1254712,135436,536,1450072,22220764
2024-11-20 03:23:05,1858332,45152,776,193828,14784,985184,366036,941840,314552,43344,51484,520908,345432,1254848,135392,536,1450072,22220788
2024-11-20 03:23:07,1858332,44744,776,193828,14784,985176,366036,941832,314552,43344,51484,520908,345432,1255012,135540,536,1450072,22220428
2024-11-20 03:23:09,1858332,44472,776,193828,14784,985364,366036,942020,314552,43344,51484,520908,345432,1255300,135576,536,1450072,22220804
2024-11-20 03:23:12,1858332,44308,776,193828,14784,985496,366036,942152,314552,43344,51484,520908,345432,1255308,135600,536,1450072,22220772
2024-11-20 03:23:15,1858332,44140,776,193828,14784,985748,366036,942404,314552,43344,51484,520908,345432,1255556,135576,536,1450072,22212516
2024-11-20 03:23:17,1858332,43884,776,193828,14784,985916,366036,942572,314552,43344,51484,520908,345432,1255732,135584,536,1450072,22220480
2024-11-20 03:23:20,1858332,43808,776,193828,14784,986148,366036,942804,314552,43344,51484,520908,345432,1255812,135392,536,1450072,22212480
2024-11-20 03:23:22,1858332,43908,776,193828,14784,985928,366036,942584,314552,43344,51484,520908,345432,1255796,135588,536,1450072,22220736
2024-11-20 03:23:25,1858332,43984,776,193828,14784,986116,366036,942772,314552,43344,51484,520908,345432,1255864,135576,536,1450072,22212392
2024-11-20 03:23:27,1858332,43508,776,193828,14784,986756,366036,943412,314552,43344,51484,520908,345432,1256444,135576,536,1450072,22220732
2024-11-20 03:23:30,1858332,43284,776,193828,14784,986648,366036,943304,314552,43344,51484,520908,345432,1256572,135576,536,1450072,22220704
2024-11-20 03:23:32,1858332,43496,776,193828,14784,986736,366036,943392,314552,43344,51484,520908,345432,1256448,135444,536,1450072,22220692
2024-11-20 03:23:35,1858332,42516,776,193828,14784,987444,366036,944100,314552,43344,51484,520908,345432,1257160,135576,536,1450072,22220796
2024-11-20 03:23:37,1858332,41664,776,193828,14784,987920,366036,944576,314552,43344,51484,520908,345432,1257484,135576,536,1450072,22220620
2024-11-20 03:23:40,1858332,40620,776,193828,14756,989236,366056,945892,314572,43344,51484,520908,345480,1259132,135600,536,1450072,22220640
2024-11-20 03:23:43,1858332,47300,776,193828,14756,982452,366056,939108,314572,43344,51484,520908,345480,1252436,135600,536,1450072,22220680
2024-11-20 03:23:46,1858332,47192,776,193828,14756,982460,366056,939116,314572,43344,51484,520908,345480,1252268,135600,536,1450072,22220804
2024-11-20 03:23:48,1858332,46956,776,193828,14756,982560,366056,939216,314572,43344,51484,520908,345480,1252388,135604,536,1450072,22220628
2024-11-20 03:23:51,1858332,46876,776,193828,14756,982672,366056,939328,314572,43344,51484,520908,345480,1252604,135600,536,1450072,22220500
2024-11-20 03:23:53,1858332,46920,776,193828,14756,982808,366056,939464,314572,43344,51484,520908,345480,1252484,135600,536,1450072,22220660
2024-11-20 03:23:56,1858332,46428,776,193828,14756,983392,366056,940048,314572,43344,51484,520908,345480,1253276,135600,536,1450072,22220752
2024-11-20 03:23:59,1858332,45828,776,193828,14756,983728,366056,940384,314572,43344,51484,520908,345480,1253392,135416,536,1450072,22220564
2024-11-20 03:24:01,1858332,46176,776,193828,14756,983728,366056,940384,314572,43344,51484,520908,345480,1253452,135468,536,1450072,22220732
2024-11-20 03:24:04,1858332,45508,776,193828,14756,984008,366056,940664,314572,43344,51484,520908,345480,1254032,135600,536,1450072,22220668
2024-11-20 03:24:06,1858332,45848,776,193828,14756,984136,366056,940792,314572,43344,51484,520908,345480,1253824,135600,536,1450072,22220828
2024-11-20 03:24:09,1858332,45688,776,193828,14756,984184,366056,940840,314572,43344,51484,520908,345480,1253908,135544,536,1450072,22220656
2024-11-20 03:24:11,1858332,45268,776,193828,14756,984216,366056,940872,314572,43344,51484,520908,345480,1253840,135416,536,1450072,22220724
2024-11-20 03:24:14,1858332,44728,776,193828,14756,984776,366056,941432,314572,43344,51484,520908,345480,1254600,135600,536,1450072,22220660
2024-11-20 03:24:17,1858332,44976,776,193828,14756,984640,366056,941296,314572,43344,51484,520908,345480,1254576,135600,536,1450072,22220640
2024-11-20 03:24:19,1858332,44760,776,193828,14756,985008,366056,941664,314572,43344,51484,520908,345480,1254676,135628,536,1450072,22220704
2024-11-20 03:24:22,1858332,44580,776,193828,14756,985476,366056,942132,314572,43344,51484,520908,345480,1255252,135600,536,1450072,22220688
2024-11-20 03:24:24,1858332,44200,776,193828,14756,985636,366056,942292,314572,43344,51484,520908,345480,1255352,135600,536,1450072,22220708
2024-11-20 03:24:26,1858332,43964,776,193828,14756,985872,366056,942528,314572,43344,51484,520908,345480,1255760,135416,536,1450072,22220664
2024-11-20 03:24:29,1858332,43744,776,193828,14756,986036,366056,942692,314572,43344,51484,520908,345480,1256220,135416,536,1450072,22220748
2024-11-20 03:24:31,1858332,43552,776,193828,14756,986140,366056,942796,314572,43344,51484,520908,345480,1255984,135652,536,1450072,22220572
2024-11-20 03:24:34,1858332,43320,776,193828,14756,986568,366056,943224,314572,43344,51484,520908,345480,1256144,135544,536,1450072,22220724
2024-11-20 03:24:36,1858332,43316,776,193828,14756,986340,366056,942996,314572,43344,51484,520908,345480,1256088,135784,536,1450072,22220556
2024-11-20 03:24:39,1858332,43108,776,193828,14756,987020,366056,943676,314572,43344,51484,520908,345480,1256720,135556,536,1450072,22220652
2024-11-20 03:24:41,1858332,43144,776,193828,14756,987028,366056,943684,314572,43344,51484,520908,345480,1256848,135600,536,1450072,22220656
2024-11-20 03:24:44,1858332,42604,776,193828,14756,987404,366056,944060,314572,43344,51484,520908,345480,1257088,135416,536,1450072,22220808
2024-11-20 03:24:46,1858332,42280,776,193828,14756,987224,366056,943880,314572,43344,51484,520908,345480,1257028,135600,536,1450072,22220556
2024-11-20 03:24:49,1858332,42532,776,193828,14756,987692,366056,944348,314572,43344,51484,520908,345480,1257428,135604,536,1450072,22220652
2024-11-20 03:24:52,1858332,42220,776,193828,14756,987648,366056,944304,314572,43344,51484,520908,345480,1257460,135416,536,1450072,22220788
2024-11-20 03:24:54,1858332,42244,776,193828,14756,987728,366056,944384,314572,43344,51484,520908,345508,1257576,135648,536,1450072,22220872
2024-11-20 03:24:57,1858332,41788,776,193828,14752,988112,366056,944768,314572,43344,51484,520908,345512,1257720,135600,536,1450072,22220700
2024-11-20 03:24:59,1858332,41556,776,193828,14752,988448,366056,945104,314572,43344,51484,520908,345512,1258136,135680,536,1450072,22220560
2024-11-20 03:25:02,1858332,41384,776,193828,14752,988504,366056,945160,314572,43344,51484,520908,345512,1258312,135600,536,1450072,22220572
2024-11-20 03:25:04,1858332,41560,776,193828,14752,988680,366056,945336,314572,43344,51484,520908,345512,1258408,135652,536,1450072,22220724
2024-11-20 03:25:07,1858332,41556,776,193828,14752,988764,366056,945420,314572,43344,51484,520908,345512,1258444,135544,536,1450072,22220596
2024-11-20 03:25:10,1858332,40772,776,193828,14752,989212,366056,945868,314572,43344,51484,520908,345512,1258764,135416,536,1450072,22220636
2024-11-20 03:25:12,1858332,47516,776,193828,14752,982712,366056,939368,314572,43344,51484,520908,345512,1252560,135652,536,1450072,22220668
2024-11-20 03:25:14,1858332,47492,776,193828,14752,982644,366056,939300,314572,43344,51484,520908,345512,1252320,135416,536,1450072,22220772
2024-11-20 03:25:17,1858332,47044,776,193828,14752,982604,366056,939260,314572,43344,51484,520908,345512,1252316,135624,536,1450072,22220804
2024-11-20 03:25:20,1858332,46816,776,193828,14752,982884,366056,939540,314572,43344,51484,520908,345512,1252564,135600,536,1450072,22220912
2024-11-20 03:25:22,1858332,43608,776,196900,14808,983256,369156,939912,314572,43344,54584,520908,345532,1253336,135988,536,1450072,22220764
2024-11-20 03:25:25,1858332,42744,776,197036,14808,983540,369340,940196,314648,43344,54692,520908,345532,1253572,135956,536,1450072,22220580
2024-11-20 03:25:27,1858332,42388,776,197036,14808,984260,369340,940916,314648,43344,54692,520908,345532,1254288,136008,536,1450072,22220632
2024-11-20 03:25:30,1858332,42328,776,197036,14808,984524,369340,941180,314648,43344,54692,520908,345532,1254224,135956,536,1450072,22220580
2024-11-20 03:25:33,1858332,42092,776,197036,14808,984896,369340,941552,314648,43344,54692,520908,345532,1254704,135772,536,1450072,22220612
2024-11-20 03:25:35,1858332,41660,776,197036,14808,984988,369340,941644,314648,43344,54692,520908,345532,1254920,135976,536,1450072,22220712
2024-11-20 03:25:38,1858332,41380,776,197036,14808,985728,369340,942384,314648,43344,54692,520908,345532,1255372,135956,536,1450072,22220624
2024-11-20 03:25:40,1858332,40852,776,197036,14808,985932,369340,942588,314648,43344,54692,520908,345532,1255752,135956,536,1450072,22220640
2024-11-20 03:25:42,1858332,40456,776,197036,14808,986240,369340,942896,314648,43344,54692,520908,345532,1256224,135776,536,1450072,22220772
2024-11-20 03:25:45,1858332,40284,776,197036,14808,986380,369340,943036,314648,43344,54692,520908,345532,1256208,135964,536,1450072,22212488
2024-11-20 03:25:47,1858332,39912,776,197036,14808,986580,369340,943236,314648,43344,54692,520908,345532,1256316,135776,536,1450072,22220548
2024-11-20 03:25:50,1858332,42524,768,193912,14808,986872,366072,943528,314512,43344,51560,520908,345532,1256496,135900,536,1450072,22220684
2024-11-20 03:25:52,1858332,42696,768,193912,14808,986936,366072,943592,314512,43344,51560,520908,345532,1256768,135960,536,1450072,22220792
2024-11-20 03:25:55,1858332,42392,768,193908,14812,987496,366072,944152,314512,43344,51560,520908,345532,1257212,136004,536,1450072,22220660
2024-11-20 03:25:58,1858332,42060,768,193912,14812,987584,366076,944240,314516,43344,51560,520908,345532,1257532,135960,536,1450072,22220528
2024-11-20 03:26:00,1858332,42168,768,193912,14812,987488,366076,944144,314516,43344,51560,520908,345532,1257244,135776,536,1450072,22220644
2024-11-20 03:26:03,1858332,41932,768,193912,14812,987980,366076,944636,314516,43344,51560,520908,345532,1257700,135900,536,1450072,22220560
2024-11-20 03:26:06,1858332,42096,768,193912,14812,987780,366076,944436,314516,43344,51560,520908,345532,1257472,135960,536,1450072,22220456
2024-11-20 03:26:08,1858332,41952,768,193912,14812,988256,366076,944912,314516,43344,51560,520908,345548,1257932,135964,536,1450072,22220708
2024-11-20 03:26:11,1858332,41748,768,193912,14812,988456,366076,945112,314516,43344,51560,520908,345548,1257960,135960,536,1450072,22220616
2024-11-20 03:26:13,1858332,41012,768,193912,14812,988940,366076,945596,314516,43344,51560,520908,345548,1258728,136012,536,1450072,22220808
2024-11-20 03:26:16,1858332,46984,768,193912,14812,982508,366076,939164,314516,43344,51560,520908,345548,1252092,135964,536,1450072,22220588
2024-11-20 03:26:19,1858332,46272,768,193912,14812,983648,366076,940304,314516,43344,51560,520908,345552,1253476,135960,536,1450072,22220668
2024-11-20 03:26:21,1858332,46276,768,193912,14812,983784,366080,940440,314520,43344,51560,520908,345552,1253352,135960,536,1450072,22220632
2024-11-20 03:26:24,1858332,46308,768,193912,14812,983880,366080,940536,314520,43344,51560,520908,345552,1253660,135960,536,1450072,22220616
2024-11-20 03:26:26,1858332,45952,768,193912,14812,984164,366080,940820,314520,43344,51560,520908,345552,1253680,135960,536,1450072,22220576
2024-11-20 03:26:29,1858332,45916,768,193912,14812,984152,366080,940808,314520,43344,51560,520908,345552,1253972,135776,536,1450072,22220628
2024-11-20 03:26:31,1858332,46036,768,193912,14812,983968,366080,940624,314520,43344,51560,520908,345552,1253972,135960,536,1450072,22220616
2024-11-20 03:26:34,1858332,45884,768,193912,14812,984528,366080,941184,314520,43344,51560,520908,345552,1254228,135980,536,1450072,22220668
2024-11-20 03:26:36,1858332,45148,768,193912,14812,984704,366080,941360,314520,43344,51560,520908,345552,1254284,135960,536,1450072,22220676
2024-11-20 03:26:39,1858332,45112,768,193912,14812,984976,366080,941632,314520,43344,51560,520908,345552,1254632,136004,536,1450072,22220624
2024-11-20 03:26:42,1858332,45024,768,193912,14812,985236,366080,941892,314520,43344,51560,520908,345552,1254928,135776,536,1450072,22220648
2024-11-20 03:26:44,1858332,44700,768,193912,14812,985272,366080,941928,314520,43344,51560,520908,345552,1254928,135880,536,1450072,22220548
2024-11-20 03:26:47,1858332,45068,768,193912,14812,985204,366080,941860,314520,43344,51560,520908,345552,1255088,135776,536,1450072,22220668
2024-11-20 03:26:49,1858332,44472,768,193912,14812,985612,366080,942268,314520,43344,51560,520908,345552,1255352,135964,536,1450072,22220784
2024-11-20 03:26:52,1858332,44396,768,193912,14812,985940,366080,942596,314520,43344,51560,520908,345552,1255648,135980,536,1450072,22220732
2024-11-20 03:26:54,1858332,43948,768,193912,14812,986108,366080,942764,314520,43344,51560,520908,345552,1256040,135960,536,1450072,22220656
2024-11-20 03:26:57,1858332,43536,768,193912,14812,986472,366080,943128,314520,43344,51560,520908,345552,1256144,136012,536,1450072,22220684
2024-11-20 03:27:00,1858332,43456,768,193912,14812,986352,366080,943008,314520,43344,51560,520908,345552,1256260,135960,536,1450072,22220628
2024-11-20 03:27:02,1858332,43308,768,193912,14812,986748,366080,943404,314520,43344,51560,520908,345552,1256420,136016,536,1450072,22220692
2024-11-20 03:27:04,1858332,43264,768,193912,14812,986672,366080,943328,314520,43344,51560,520908,345552,1256416,135964,536,1450072,22220692
2024-11-20 03:27:07,1858332,42784,768,193912,14812,987128,366080,943784,314520,43344,51560,520908,345552,1256840,135968,536,1450072,22220740
2024-11-20 03:27:10,1858332,42828,768,193912,14812,986980,366080,943636,314520,43344,51560,520908,345552,1256684,135964,536,1450072,22220740
2024-11-20 03:27:12,1858332,42844,768,193912,14812,987320,366080,943976,314520,43344,51560,520908,345552,1256924,136016,536,1450072,22220764
2024-11-20 03:27:15,1858332,42252,768,193912,14812,987684,366080,944340,314520,43344,51560,520908,345552,1257416,136012,536,1450072,22220700
2024-11-20 03:27:18,1858332,41992,768,193912,14812,987688,366080,944344,314520,43344,51560,520908,345552,1257404,135964,536,1450072,22220720
2024-11-20 03:27:20,1858332,41748,768,193912,14812,987868,366080,944524,314520,43344,51560,520908,345552,1257444,135964,536,1450072,22220708
2024-11-20 03:27:23,1858332,41332,768,193912,14812,988200,366080,944856,314520,43344,51560,520908,345552,1257708,135984,536,1450072,22220656
2024-11-20 03:27:26,1858332,41472,768,193912,14812,988212,366080,944868,314520,43344,51560,520908,345552,1258044,136148,536,1450072,22220592
2024-11-20 03:27:28,1858332,41568,768,193912,14812,988228,366080,944884,314520,43344,51560,520908,345552,1257924,135964,536,1450072,22220452
2024-11-20 03:27:30,1858332,40960,768,193912,14812,988568,366080,945224,314520,43344,51560,520908,345552,1258264,135964,536,1450072,22220812
2024-11-20 03:27:33,1858332,41052,768,193912,14812,988560,366080,945216,314520,43344,51560,520908,345552,1258276,135964,536,1450072,22220684
2024-11-20 03:27:35,1858332,40492,768,193912,14812,989160,366080,945816,314520,43344,51560,520908,345552,1258800,135984,536,1450072,22220640
2024-11-20 03:27:38,1858332,47040,768,193912,14812,982376,366080,939032,314520,43344,51560,520908,345556,1252004,135808,536,1450072,22220648
2024-11-20 03:27:40,1858332,47044,768,193912,14808,982316,366084,938972,314524,43344,51560,520908,345560,1251972,135964,536,1450072,22220824
2024-11-20 03:27:43,1858332,47256,768,193912,14808,982392,366084,939048,314524,43344,51560,520908,345560,1252236,135964,536,1450072,22220768
2024-11-20 03:27:45,1858332,46976,768,193912,14808,982732,366084,939388,314524,43344,51560,520908,345560,1252468,135964,536,1450072,22220832
2024-11-20 03:27:48,1858332,46472,768,193912,14804,983396,366084,940052,314524,43344,51560,520908,345564,1253272,135780,536,1450072,22220728
2024-11-20 03:27:50,1858332,46940,768,193912,14804,983684,366084,940340,314524,43344,51560,520908,345564,1253388,136000,536,1450072,22220748
2024-11-20 03:27:53,1858332,46248,768,193912,14804,983908,366084,940564,314524,43344,51560,520908,345564,1253684,135964,536,1450072,22220616
2024-11-20 03:27:55,1858332,45956,768,193912,14804,984252,366084,940908,314524,43344,51560,520908,345564,1253944,135800,536,1450072,22220576
2024-11-20 03:27:58,1858332,45784,768,193912,14804,984292,366084,940948,314524,43344,51560,520908,345564,1253900,135780,536,1450072,22220812
2024-11-20 03:28:00,1858332,45572,768,193912,14804,984476,366084,941132,314524,43344,51560,520908,345564,1254472,135808,536,1450072,22220672
2024-11-20 03:28:03,1858332,45120,768,193912,14804,985108,366084,941764,314524,43344,51560,520908,345564,1254780,135964,536,1450072,22220776
2024-11-20 03:28:05,1858332,44772,768,193912,14804,985172,366084,941828,314524,43344,51560,520908,345564,1254748,135964,536,1450072,22220688
2024-11-20 03:28:08,1858332,44816,768,193912,14804,985268,366096,941924,314536,43344,51560,520908,345576,1254912,135984,536,1450072,22220604
2024-11-20 03:28:10,1858332,44568,768,193912,14804,985540,366096,942196,314536,43344,51560,520908,345576,1255144,135964,536,1450072,22220772
2024-11-20 03:28:13,1858332,43960,768,193912,14804,985908,366096,942564,314536,43344,51560,520908,345576,1255428,135964,536,1450072,22220608
2024-11-20 03:28:15,1858332,44060,768,193912,14804,985716,366096,942372,314536,43344,51560,520908,345576,1255692,136016,536,1450072,22220712
2024-11-20 03:28:18,1858332,43932,768,193912,14804,986180,366096,942836,314536,43344,51560,520908,345576,1256068,135860,536,1450072,22220824
2024-11-20 03:28:21,1858332,43468,768,193912,14804,986332,366096,942988,314536,43344,51560,520908,345576,1256104,135964,536,1450072,22220804
2024-11-20 03:28:23,1858332,43336,768,193912,14804,986352,366096,943008,314536,43344,51560,520908,345576,1256152,135964,536,1450072,22220744
2024-11-20 03:28:26,1858332,43568,768,193912,14804,986724,366096,943380,314536,43344,51560,520908,345576,1256432,135964,536,1450072,22220716
2024-11-20 03:28:28,1858332,42716,768,193912,14804,986856,366096,943512,314536,43344,51560,520908,345576,1256548,135832,536,1450072,22220804
2024-11-20 03:28:31,1858332,43044,768,193912,14804,986788,366096,943444,314536,43344,51560,520908,345576,1256600,135828,536,1450072,22220584
2024-11-20 03:28:33,1858332,42424,768,193912,14804,987256,366096,943912,314536,43344,51560,520908,345576,1256848,135780,536,1450072,22220664
2024-11-20 03:28:36,1858332,42428,768,193912,14804,987364,366096,944020,314536,43344,51560,520908,345576,1257156,135964,536,1450072,22220692
2024-11-20 03:28:38,1858332,42048,768,193912,14804,987524,366096,944180,314536,43344,51560,520908,345576,1257276,135964,536,1450072,22220780
2024-11-20 03:28:41,1858332,42016,768,193912,14804,987672,366096,944328,314536,43344,51560,520908,345576,1257348,136012,536,1450072,22220680
2024-11-20 03:28:43,1858332,41824,768,193912,14804,987908,366096,944564,314536,43344,51560,520908,345576,1257712,135964,536,1450072,22220704
2024-11-20 03:28:46,1858332,41824,768,193912,14804,987844,366096,944500,314536,43344,51560,520908,345576,1257716,135972,536,1450072,22220580
2024-11-20 03:28:49,1858332,41736,768,193912,14804,988060,366096,944716,314536,43344,51560,520908,345576,1257720,135964,536,1450072,22220748
2024-11-20 03:28:51,1858332,41120,768,193912,14804,988500,366096,945156,314536,43344,51560,520908,345576,1258200,135976,536,1450072,22220752
2024-11-20 03:28:54,1858332,40552,768,193952,14804,989244,366136,945900,314536,43344,51600,520908,345576,1259040,135784,536,1450072,22220672
2024-11-20 03:28:56,1858332,45776,768,193952,14804,983208,366136,939864,314536,43344,51600,520908,345576,1252992,136028,536,1450072,22220580
2024-11-20 03:28:59,1858332,45416,768,193952,14804,984352,366136,941008,314536,43344,51600,520908,345576,1254068,135976,536,1450072,22220728
2024-11-20 03:29:01,1858332,45332,768,193952,14804,984428,366136,941084,314536,43344,51600,520908,345576,1254076,135976,536,1450072,22220752
2024-11-20 03:29:04,1858332,45044,768,193952,14804,984608,366136,941264,314536,43344,51600,520908,345576,1254232,135996,536,1450072,22220628
2024-11-20 03:29:07,1858332,45196,768,193952,14804,984624,366136,941280,314536,43344,51600,520908,345576,1254404,135976,536,1450072,22220704
2024-11-20 03:29:09,1858332,45108,768,193952,14804,985020,366136,941676,314536,43344,51600,520908,345576,1254748,135924,536,1450072,22220708
2024-11-20 03:29:12,1858332,44528,768,193952,14804,985012,366136,941668,314536,43344,51600,520908,345576,1254620,135976,536,1450072,22220620
2024-11-20 03:29:14,1858332,44464,768,193952,14804,985612,366136,942268,314536,43344,51600,520908,345576,1255292,136036,536,1450072,22220860
2024-11-20 03:29:16,1858332,44432,768,193952,14804,985476,366136,942132,314536,43344,51600,520908,345576,1255108,135976,536,1450072,22220716
2024-11-20 03:29:19,1858332,44076,768,193952,14804,985760,366136,942416,314536,43344,51600,520908,345576,1255384,135792,536,1450072,22220632
2024-11-20 03:29:21,1858332,43924,768,193952,14804,985852,366136,942508,314536,43344,51600,520908,345576,1255576,136004,536,1450072,22220680
2024-11-20 03:29:24,1858332,43584,768,193952,14804,986164,366136,942820,314536,43344,51600,520908,345576,1255648,135976,536,1450072,22220752
2024-11-20 03:29:26,1858332,43556,768,193952,14804,986140,366136,942796,314536,43344,51600,520908,345576,1255976,135964,536,1450072,22220656
2024-11-20 03:29:29,1858332,43640,768,193952,14804,986304,366136,942960,314536,43344,51600,520908,345576,1255912,135976,536,1450072,22220640
2024-11-20 03:29:31,1858332,43356,768,193952,14804,986252,366136,942908,314536,43344,51600,520908,345576,1256120,135844,536,1450072,22220696
2024-11-20 03:29:34,1858332,43068,768,193952,14804,986760,366136,943416,314536,43344,51600,520908,345576,1256376,135976,536,1450072,22220648
2024-11-20 03:29:36,1858332,43052,768,193952,14804,986844,366136,943500,314536,43344,51600,520908,345576,1256372,135996,536,1450072,22220680
2024-11-20 03:29:39,1858332,42892,768,193952,14804,987072,366136,943728,314536,43344,51600,520908,345576,1256972,135976,536,1450072,22220500
2024-11-20 03:29:41,1858332,42468,768,193952,14804,987020,366136,943676,314536,43344,51600,520908,345576,1256672,135996,536,1450072,22220832
2024-11-20 03:29:44,1858332,42348,768,193952,14804,987180,366136,943836,314536,43344,51600,520908,345576,1257096,135896,536,1450072,22220728
2024-11-20 03:29:47,1858332,42392,768,193952,14804,987080,366136,943736,314536,43344,51600,520908,345576,1256848,135792,536,1450072,22220720
2024-11-20 03:29:49,1858332,41908,768,193952,14804,987888,366140,944544,314540,43344,51600,520908,345580,1257772,135996,536,1450072,22220780
2024-11-20 03:29:52,1858332,40364,768,194472,14812,988644,366684,945300,314564,43344,52120,520908,345596,1258288,135932,536,1450072,22220956
2024-11-20 03:29:54,1858332,40652,768,194472,14812,988812,366692,945468,314572,43344,52120,520908,345604,1258484,135992,536,1450072,22220740
2024-11-20 03:29:57,1858332,39652,768,194472,14812,989664,366692,946320,314572,43344,52120,520908,345672,1259344,136040,536,1450072,22220644
2024-11-20 03:30:00,1858332,46124,768,194472,14812,982744,366700,939400,314580,43344,52120,520908,345680,1252560,135808,536,1450072,22220744
2024-11-20 03:30:02,1858332,45772,768,194472,14812,983000,366700,939656,314580,43344,52120,520908,345680,1252820,135776,536,1450072,22220776
2024-11-20 03:30:04,1858332,45876,768,194472,14812,983188,366700,939844,314580,43344,52120,520908,345680,1252836,135992,536,1450072,22220688
2024-11-20 03:30:07,1858332,45596,768,194472,14812,983440,366700,940096,314580,43344,52120,520908,345680,1253172,136012,536,1450072,22220772
2024-11-20 03:30:09,1858332,45668,768,194472,14812,983496,366700,940152,314580,43344,52120,520908,345680,1253372,135992,536,1450072,22220628
2024-11-20 03:30:12,1858332,45500,768,194472,14812,984048,366700,940704,314580,43344,52120,520908,345680,1253776,136012,536,1450072,22220600
2024-11-20 03:30:14,1858332,44620,768,194472,14816,983904,366716,940560,314596,43344,52120,520908,345692,1253620,135992,536,1450072,22220680
2024-11-20 03:30:16,1858332,43952,768,194472,14816,984192,366716,940848,314596,43344,52120,520908,345692,1253868,135992,536,1450072,22220716
2024-11-20 03:30:18,1858332,43732,768,194472,14816,984252,366716,940908,314596,43344,52120,520908,345692,1253968,135992,536,1450072,22220748
2024-11-20 03:30:20,1858332,43916,768,194472,14816,984648,366716,941304,314596,43344,52120,520908,345692,1254452,135992,536,1450072,22220768
2024-11-20 03:30:22,1858332,43540,768,194472,14816,984876,366716,941532,314596,43344,52120,520908,345692,1254744,135992,536,1450072,22220728
2024-11-20 03:30:25,1858332,43644,768,194472,14816,984700,366716,941356,314596,43344,52120,520908,345692,1254484,135992,536,1450072,22220728
2024-11-20 03:30:27,1858332,43128,768,194472,14816,985320,366716,941976,314596,43344,52120,520908,345692,1255264,135992,536,1450072,22220740
2024-11-20 03:30:29,1858332,42912,768,194472,14816,985428,366716,942084,314596,43344,52120,520908,345692,1255324,135992,536,1450072,22220832
2024-11-20 03:30:31,1858332,42512,768,194472,14816,985552,366716,942208,314596,43344,52120,520908,345692,1255292,135992,536,1450072,22220896
2024-11-20 03:30:33,1858332,43240,768,194472,14816,985700,366716,942356,314596,43344,52120,520908,345692,1255368,135992,536,1450072,22220660
2024-11-20 03:30:36,1858332,43420,768,194472,14816,985760,366724,942416,314604,43344,52120,520908,345708,1255476,136012,536,1450072,22220832
2024-11-20 03:30:39,1858332,42952,768,194472,14816,985900,366724,942556,314604,43344,52120,520908,345708,1255696,135992,536,1450072,22220776
2024-11-20 03:30:41,1858332,42568,768,194472,14816,986352,366724,943008,314604,43344,52120,520908,345708,1256152,135844,536,1450072,22220804
2024-11-20 03:30:44,1858332,42504,768,194472,14816,986440,366724,943096,314604,43344,52120,520908,345708,1256212,135956,536,1450072,22220696
2024-11-20 03:30:47,1858332,42428,768,194472,14816,986408,366724,943064,314604,43344,52120,520908,345708,1256096,135992,536,1450072,22220752
2024-11-20 03:30:49,1858332,42260,768,194472,14816,986572,366724,943228,314604,43344,52120,520908,345708,1256540,135992,536,1450072,22220620
2024-11-20 03:30:52,1858332,44120,768,194472,14816,984708,366724,941364,314604,43344,52120,520908,345708,1254716,135808,536,1450072,22220732
2024-11-20 03:30:54,1858332,42128,768,194472,14816,986952,366724,943608,314604,43344,52120,520908,345708,1256660,136012,536,1450072,22220624
2024-11-20 03:30:56,1858332,41516,768,194472,14816,986972,366728,943628,314608,43344,52120,520908,345712,1256720,135992,536,1450072,22220556
2024-11-20 03:30:59,1858332,41440,768,194472,14816,987420,366728,944076,314608,43344,52120,520908,345712,1257224,136012,536,1450072,22220756
2024-11-20 03:31:01,1858332,40960,768,194472,14816,987948,366728,944604,314608,43344,52120,520908,345712,1257728,135992,536,1450072,22220820
2024-11-20 03:31:04,1858332,40848,768,194472,14816,988332,366728,944988,314608,43344,52120,520908,345712,1258164,136012,536,1450072,22220612
2024-11-20 03:31:06,1858332,40352,768,194472,14816,988840,366728,945496,314608,43344,52120,520908,345712,1258804,135992,536,1450072,22220728
2024-11-20 03:31:09,1858332,39964,768,194472,14816,989336,366728,945992,314608,43344,52120,520908,345712,1259384,135912,536,1450072,22220580
2024-11-20 03:31:12,1858332,46304,768,194472,14816,983092,366728,939748,314608,43344,52120,520908,345712,1252908,135996,536,1450072,22220728
2024-11-20 03:31:14,1858332,46268,768,194472,14816,983368,366728,940024,314608,43344,52120,520908,345712,1253148,135812,536,1450072,22220696
2024-11-20 03:31:17,1858332,46096,768,194472,14816,983764,366728,940420,314608,43344,52120,520908,345712,1253548,136016,536,1450072,22220720
2024-11-20 03:31:19,1858332,45724,768,194472,14816,984112,366728,940768,314608,43344,52120,520908,345712,1253812,135996,536,1450072,22220696
2024-11-20 03:31:22,1858332,45408,768,194472,14816,984448,366728,941104,314608,43344,52120,520908,345712,1254376,136016,536,1450072,22220688
2024-11-20 03:31:24,1858332,45336,768,194472,14816,984500,366728,941156,314608,43344,52120,520908,345712,1254344,135812,536,1450072,22220580
2024-11-20 03:31:27,1858332,44756,768,194472,14816,984712,366732,941368,314612,43344,52120,520908,345716,1254612,136016,536,1450072,22220720
2024-11-20 03:31:29,1858332,44712,768,194472,14816,984764,366732,941420,314612,43344,52120,520908,345716,1254432,135996,536,1450072,22220704
2024-11-20 03:31:32,1858332,44628,768,194472,14816,985112,366732,941768,314612,43344,52120,520908,345716,1254824,135944,536,1450072,22220676
2024-11-20 03:31:35,1858332,44188,768,194472,14816,985576,366732,942232,314612,43344,52120,520908,345716,1255296,135996,536,1450072,22220808
2024-11-20 03:31:37,1858332,43700,768,194472,14816,986052,366732,942708,314612,43344,52120,520908,345716,1255808,135836,536,1450072,22220860
2024-11-20 03:31:40,1858332,42616,768,194472,14816,986760,366732,943416,314612,43344,52120,520908,345716,1256788,135812,536,1450072,22220560
2024-11-20 03:31:42,1858332,42408,768,194472,14816,987084,366732,943740,314612,43344,52120,520908,345716,1257104,136016,536,1450072,22220744
2024-11-20 03:31:45,1858332,42484,768,194472,14816,987212,366732,943868,314612,43344,52120,520908,345716,1256892,135996,536,1450072,22220512
2024-11-20 03:31:48,1858332,41712,768,194472,14816,987860,366732,944516,314612,43344,52120,520908,345716,1257408,135812,536,1450072,22220748
2024-11-20 03:31:50,1858332,41920,768,194472,14816,987660,366732,944316,314612,43344,52120,520908,345716,1257384,136000,536,1450072,22220712
2024-11-20 03:31:53,1858332,41800,768,194472,14816,987868,366732,944524,314612,43344,52120,520908,345716,1257680,135812,536,1450072,22220680
2024-11-20 03:31:56,1858332,41352,768,194472,14816,988248,366732,944904,314612,43344,52120,520908,345724,1257936,135996,536,1450072,22220716
2024-11-20 03:31:58,1858332,41360,768,194472,14816,988104,366732,944760,314612,43344,52120,520908,345724,1257888,135996,536,1450072,22220568
2024-11-20 03:32:00,1858332,41316,768,194472,14816,988168,366732,944824,314612,43344,52120,520908,345724,1258012,135812,536,1450072,22220576
2024-11-20 03:32:03,1858332,40888,768,194472,14816,988616,366732,945272,314612,43344,52120,520908,345724,1258620,135996,536,1450072,22220664
2024-11-20 03:32:05,1858332,40556,768,194472,14816,988648,366732,945304,314612,43344,52120,520908,345724,1258440,135812,536,1450072,22220724
2024-11-20 03:32:08,1858332,40472,768,194472,14816,989028,366732,945684,314612,43344,52120,520908,345724,1258816,135996,536,1450072,22220600
2024-11-20 03:32:10,1858332,40284,768,194472,14816,989020,366732,945676,314612,43344,52120,520908,345724,1258924,136016,536,1450072,22220488
2024-11-20 03:32:12,1858332,39772,768,194472,14816,989428,366732,946084,314612,43344,52120,520908,345724,1259204,135996,536,1450072,22220800
2024-11-20 03:32:15,1858332,46052,768,194472,14816,983132,366732,939788,314612,43344,52120,520908,345724,1252776,135964,536,1450072,22220504
2024-11-20 03:32:17,1858332,45576,768,194472,14816,983380,366732,940036,314612,43344,52120,520908,345724,1253148,135996,536,1450072,22220728
2024-11-20 03:32:20,1858332,45908,768,194472,14816,983252,366732,939908,314612,43344,52120,520908,345724,1253448,135996,536,1450072,22220620
2024-11-20 03:32:22,1858332,45568,768,194472,14816,983528,366732,940184,314612,43344,52120,520908,345724,1253520,135812,536,1450072,22220744
2024-11-20 03:32:25,1858332,45540,768,194472,14816,983668,366732,940324,314612,43344,52120,520908,345724,1253380,135996,536,1450072,22220788
2024-11-20 03:32:27,1858332,44868,768,194472,14816,983956,366732,940612,314612,43344,52120,520908,345724,1253848,135812,536,1450072,22220832
2024-11-20 03:32:30,1858332,45120,768,194472,14816,983992,366732,940648,314612,43344,52120,520908,345724,1253876,135996,536,1450072,22220832
2024-11-20 03:32:32,1858332,44928,768,194472,14816,984040,366732,940696,314612,43344,52120,520908,345724,1254068,135996,536,1450072,22220604
2024-11-20 03:32:35,1858332,44940,768,194472,14816,984288,366732,940944,314612,43344,52120,520908,345724,1254168,135812,536,1450072,22220800
2024-11-20 03:32:37,1858332,44716,768,194472,14816,984556,366732,941212,314612,43344,52120,520908,345724,1254248,135996,536,1450072,22220776
2024-11-20 03:32:40,1858332,45716,916,196524,15200,982512,367648,939044,313664,43468,53984,520908,347492,1251468,138964,536,1450072,22085024
2024-11-20 03:32:42,1858332,46768,916,197208,15212,982420,368152,938464,313800,43956,54352,520908,347748,1250648,136172,536,1450072,22082540
2024-11-20 03:32:44,1858332,46772,916,197208,15212,982404,368152,938448,313800,43956,54352,520908,347748,1250512,136204,536,1450072,22082444
2024-11-20 03:32:46,1858332,46076,916,197240,15212,982624,368224,938664,313804,43960,54420,520908,347748,1251036,136272,536,1450072,22082404
2024-11-20 03:32:48,1858332,46268,916,197240,15212,982684,368228,938724,313808,43960,54420,520908,347752,1250908,136208,536,1450072,22082392
2024-11-20 03:32:50,1858332,45704,916,197240,15212,982872,368228,938912,313808,43960,54420,520908,347752,1251108,136208,536,1450072,22082476
2024-11-20 03:32:52,1858332,45688,916,197240,15212,983064,368228,939104,313808,43960,54420,520908,347752,1251344,136208,536,1450072,22082344
2024-11-20 03:32:54,1858332,45468,916,197240,15212,983368,368228,939408,313808,43960,54420,520908,347752,1251704,136208,536,1450072,22082328
2024-11-20 03:32:56,1858332,45128,916,197240,15212,983444,368232,939484,313812,43960,54420,520908,347756,1251712,136208,536,1450072,22082408
2024-11-20 03:32:59,1858332,44848,916,197240,15212,983680,368232,939720,313812,43960,54420,520908,347756,1252024,136208,536,1450072,22082516
2024-11-20 03:33:01,1858332,44024,916,197240,15212,984288,368232,940328,313812,43960,54420,520908,347756,1252520,136208,536,1450072,22082532
2024-11-20 03:33:03,1858332,43888,916,197240,15212,984292,368232,940332,313812,43960,54420,520908,347756,1252540,136208,536,1450072,22082424
