Timestamp,MemTotal,MemFree,Buffers,Cached,SwapCached,Active,Inactive,Active(anon),Inactive(anon),Active(file),Inactive(file),SwapTotal,SwapFree,AnonPages,Mapped,Shmem,CommitLimit,Committed_AS
2024-11-20 06:21:34,1858332,1102864,672,260312,18380,73340,217736,35316,94672,38024,123064,520908,365916,128428,146668,568,1450072,22185432
2024-11-20 06:21:34,1858332,1102864,672,260312,18380,73340,217736,35316,94672,38024,123064,520908,365916,128428,146668,568,1450072,22185432
2024-11-20 06:21:34,1858332,1102864,672,260312,18380,73340,217736,35316,94672,38024,123064,520908,365916,128428,146668,568,1450072,22185432
2024-11-20 06:21:34,1858332,1102864,672,260312,18380,73340,217736,35316,94672,38024,123064,520908,365916,128428,146668,568,1450072,22185432
2024-11-20 06:21:34,1858332,1102864,672,260312,18380,73340,217736,35316,94672,38024,123064,520908,365916,128428,146668,568,1450072,22185432
2024-11-20 06:21:34,1858332,1102864,672,260312,18380,73340,217736,35316,94672,38024,123064,520908,365916,128428,146668,568,1450072,22185432
2024-11-20 06:21:34,1858332,1102864,672,260312,18380,73340,217736,35316,94672,38024,123064,520908,365916,128428,146668,568,1450072,22185432
2024-11-20 06:21:34,1858332,1102864,672,260312,18380,73340,217736,35316,94672,38024,123064,520908,365916,128428,146668,568,1450072,22185432
2024-11-20 06:21:34,1858332,1102864,672,260312,18380,73340,217736,35316,94672,38024,123064,520908,365916,128428,146668,568,1450072,22185432
2024-11-20 06:21:34,1858332,1102864,672,260312,18380,73340,217736,35316,94672,38024,123064,520908,365916,128428,146668,568,1450072,22185432
2024-11-20 06:21:34,1858332,1102864,672,260312,18380,73340,217736,35316,94672,38024,123064,520908,365916,128428,146668,568,1450072,22185432
2024-11-20 06:21:36,1858332,1039300,904,278232,18376,127956,226720,82052,93296,45904,133424,520908,366280,174112,152396,568,1450072,22408100
2024-11-20 06:21:38,1858332,811148,904,375892,18376,258136,324216,212224,93280,45912,230936,520908,366280,304548,152560,568,1450072,23209928
2024-11-20 06:21:40,1858332,33044,280,593480,18376,944556,413836,697744,166792,246812,247044,520908,365988,863312,152568,568,1450072,23209808
2024-11-20 06:21:43,1858332,32556,76,195976,18376,1031236,328864,983272,280764,47964,48100,520908,365992,1262568,138864,564,1450072,22212828
2024-11-20 06:21:45,1858332,37996,188,192960,18376,1017088,347332,978212,293100,38876,54232,520908,365972,1269488,141860,560,1450072,22212216
2024-11-20 06:21:47,1858332,53384,420,191460,18360,997096,366376,950528,321048,46568,45328,520908,365164,1269568,138244,560,1450072,20290664
2024-11-20 06:21:49,1858332,53284,420,191480,18360,996996,366364,950340,320920,46656,45444,520908,365172,1269588,138248,560,1450072,20290528
2024-11-20 06:21:52,1858332,49008,452,191820,18364,1000388,366720,953732,320896,46656,45824,520908,365184,1273116,141744,560,1450072,22211992
2024-11-20 06:21:54,1858332,33320,428,193904,18288,1013148,369948,966560,322160,46588,47788,520908,365016,1287456,149424,560,1450072,24133612
2024-11-20 06:21:56,1858332,41176,436,188868,18284,996348,363724,953040,317528,43308,46196,520908,363368,1268680,138452,560,1450072,20290648
2024-11-20 06:21:59,1858332,41188,436,188868,18284,996560,363692,953252,317496,43308,46196,520908,363368,1268872,138452,560,1450072,20290660
2024-11-20 06:22:01,1858332,39896,444,189780,18284,996916,364436,953608,317372,43308,47064,520908,363368,1269304,138636,560,1450072,20290556
2024-11-20 06:22:03,1858332,42116,444,190048,18284,994768,363820,951460,316468,43308,47352,520908,363396,1266012,137760,560,1450072,20290424
2024-11-20 06:22:05,1858332,40368,444,192492,18232,994892,365924,951584,316184,43308,49740,520908,364340,1266028,137760,560,1450072,20290460
2024-11-20 06:22:08,1858332,38180,444,194804,18248,995432,367820,952124,315680,43308,52140,520908,364588,1266076,137880,560,1450072,20290576
2024-11-20 06:22:10,1858332,38204,444,194804,18248,995340,367812,952032,315672,43308,52140,520908,364588,1266036,137880,560,1450072,20290420
2024-11-20 06:22:12,1858332,38992,376,190888,18256,998508,365880,953808,319112,44700,46768,520908,364016,1271264,143904,560,1450072,22211184
2024-11-20 06:22:15,1858332,32432,500,193860,18256,1002636,368100,957096,319124,45540,48976,520908,364020,1274676,145404,564,1450072,22211588
2024-11-20 06:22:17,1858332,41256,472,193040,18256,997768,364920,950340,318692,47428,46228,520908,363440,1266960,138604,560,1450072,20290584
2024-11-20 06:22:19,1858332,40740,480,192940,18256,998096,364704,950668,318512,47428,46192,520908,363440,1267300,138808,560,1450072,20290520
2024-11-20 06:22:22,1858332,40952,480,192948,18256,998160,364704,950732,318512,47428,46192,520908,363440,1267320,138808,560,1450072,20290616
2024-11-20 06:22:24,1858332,41404,480,194360,18272,998572,365504,951144,317892,47428,47612,520908,363456,1267240,138820,560,1450072,20290516
2024-11-20 06:22:26,1858332,41268,480,194360,18272,998416,365480,950988,317868,47428,47612,520908,363620,1267000,138784,560,1450072,20290436
2024-11-20 06:22:29,1858332,37744,480,197856,18272,998784,368820,951356,317860,47428,50960,520908,363624,1267152,138784,560,1450072,20290504
2024-11-20 06:22:31,1858332,39028,480,196684,18272,999416,366772,951724,317100,47692,49672,520908,362576,1267016,139220,560,1450072,20290556
2024-11-20 06:22:34,1858332,38936,480,196792,18272,999748,366880,952056,317100,47692,49780,520908,362576,1267260,138968,560,1450072,20290432
2024-11-20 06:22:37,1858332,38596,480,196792,18272,999540,366880,951848,317100,47692,49780,520908,362576,1267056,139032,560,1450072,20290520
2024-11-20 06:22:39,1858332,38392,484,196824,18272,999820,366916,952128,317100,47692,49816,520908,362576,1267300,139096,560,1450072,20290508
2024-11-20 06:22:42,1858332,38372,484,196824,18272,999848,366916,952156,317100,47692,49816,520908,362576,1267384,138852,560,1450072,20290524
2024-11-20 06:22:44,1858332,37788,484,196824,18272,1000584,366912,952892,317096,47692,49816,520908,362576,1267976,139128,560,1450072,20290500
2024-11-20 06:22:47,1858332,37980,484,196824,18272,1000692,366912,953000,317096,47692,49816,520908,362576,1268260,139220,560,1450072,20290404
2024-11-20 06:22:49,1858332,37776,484,196824,18272,1000976,366912,953284,317096,47692,49816,520908,362576,1268564,139220,560,1450072,20290388
2024-11-20 06:22:52,1858332,37160,484,196824,18272,1001304,366912,953612,317096,47692,49816,520908,362652,1268864,139036,560,1450072,20290424
2024-11-20 06:22:55,1858332,36504,484,196824,18272,1002148,366908,954456,317092,47692,49816,520908,362652,1269728,139220,560,1450072,20290480
2024-11-20 06:22:57,1858332,42348,484,196824,18272,996504,366356,948812,316540,47692,49816,520908,362656,1263424,138348,560,1450072,20290540
2024-11-20 06:23:00,1858332,42364,484,196824,18272,996956,366352,949264,316536,47692,49816,520908,362656,1264000,138284,560,1450072,20290448
2024-11-20 06:23:02,1858332,42308,484,196824,18276,996752,366356,949060,316540,47692,49816,520908,362676,1263880,138196,560,1450072,20290372
2024-11-20 06:23:05,1858332,42056,484,196920,18276,997176,366432,949484,316520,47692,49912,520908,362676,1264068,138312,560,1450072,20290544
2024-11-20 06:23:08,1858332,41652,484,197032,18276,997500,366540,949808,316516,47692,50024,520908,362680,1264496,138476,560,1450072,20290540
2024-11-20 06:23:10,1858332,41304,484,197032,18276,997556,366544,949864,316520,47692,50024,520908,362680,1264480,138344,560,1450072,20290536
2024-11-20 06:23:13,1858332,41444,484,197032,18260,997768,366460,950076,316436,47692,50024,520908,363044,1264736,138476,560,1450072,20290648
2024-11-20 06:23:15,1858332,41344,484,197032,18260,998176,366460,950484,316436,47692,50024,520908,363044,1265048,138416,560,1450072,20290596
2024-11-20 06:23:18,1858332,40756,484,194268,18264,1000212,364876,952728,317356,47484,47520,520908,362716,1268348,142172,560,1450072,22211864
2024-11-20 06:23:20,1858332,36012,484,192032,18260,1004124,364604,957840,318172,46284,46432,520908,362232,1274424,146524,560,1450072,24134496
2024-11-20 06:23:23,1858332,41264,496,189296,18260,999188,364556,953764,319988,45424,44568,520908,361832,1272328,145148,560,1450072,22211732
2024-11-20 06:23:25,1858332,40704,504,189484,18260,999560,364560,954124,319992,45436,44568,520908,361836,1272636,145356,560,1450072,22211536
2024-11-20 06:23:28,1858332,40008,504,190320,18260,999508,365576,954068,319992,45440,45584,520908,361836,1272520,145304,560,1450072,22211500
2024-11-20 06:23:30,1858332,39856,512,190320,18260,999768,365584,954328,319992,45440,45592,520908,361836,1272548,145304,560,1450072,22211448
2024-11-20 06:23:33,1858332,39480,512,190320,18260,999920,365584,954480,319992,45440,45592,520908,361836,1272868,145488,560,1450072,22211560
2024-11-20 06:23:35,1858332,39672,512,190700,18260,1000012,365364,954572,319416,45440,45948,520908,361836,1272432,145524,560,1450072,22211632
2024-11-20 06:23:38,1858332,39664,512,190700,18260,1000256,365368,954816,319396,45440,45972,520908,361836,1272680,145500,560,1450072,22211668
2024-11-20 06:23:40,1858332,39568,512,190700,18260,1000144,365368,954704,319396,45440,45972,520908,361836,1272460,145500,560,1450072,22211740
2024-11-20 06:23:43,1858332,39404,512,190700,18260,1000448,365360,955000,319396,45448,45964,520908,361836,1272580,145584,560,1450072,22211652
2024-11-20 06:23:46,1858332,39140,512,190700,18260,1001032,365364,955584,319400,45448,45964,520908,361840,1273460,145500,560,1450072,22211704
2024-11-20 06:23:48,1858332,38548,512,190700,18260,1001284,365364,955836,319400,45448,45964,520908,361840,1273724,145548,560,1450072,22211616
2024-11-20 06:23:50,1858332,38100,512,190700,18260,1001612,365364,956164,319400,45448,45964,520908,361840,1273772,145500,560,1450072,22211644
2024-11-20 06:23:53,1858332,38204,512,190700,18260,1001720,365364,956272,319400,45448,45964,520908,361840,1274020,145504,560,1450072,22211732
2024-11-20 06:23:56,1858332,38456,512,190700,18260,1001752,365364,956304,319400,45448,45964,520908,361884,1273852,145504,560,1450072,22211596
2024-11-20 06:23:58,1858332,37852,512,190700,18260,1002088,365372,956640,319408,45448,45964,520908,361884,1274544,145568,560,1450072,22211520
2024-11-20 06:24:00,1858332,37744,512,190700,18260,1002364,365372,956916,319408,45448,45964,520908,361884,1274668,145504,560,1450072,22211560
2024-11-20 06:24:03,1858332,33984,512,190700,18260,1005596,365376,960148,319412,45448,45964,520908,361888,1277992,145580,560,1450072,22211420
2024-11-20 06:24:06,1858332,37060,512,190928,18260,1002376,366304,956956,320112,45420,46192,520908,361508,1275476,138768,560,1450072,20290596
2024-11-20 06:24:08,1858332,38468,504,190008,18260,1003420,364064,957992,318876,45428,45188,520908,360124,1274760,137352,556,1450072,20290460
2024-11-20 06:24:11,1858332,45428,504,190040,18260,996324,364144,950896,318824,45428,45320,520908,360280,1267844,136820,556,1450072,20290476
2024-11-20 06:24:13,1858332,44644,504,190908,18260,996656,364456,951228,318268,45428,46188,520908,360280,1267720,136828,556,1450072,20290568
2024-11-20 06:24:16,1858332,45732,504,190908,18260,995960,364428,950532,318240,45428,46188,520908,360280,1266980,136912,556,1450072,20290452
2024-11-20 06:24:18,1858332,45564,504,190908,18260,996420,364404,950992,318216,45428,46188,520908,360280,1267472,136736,556,1450072,20290412
2024-11-20 06:24:21,1858332,45772,504,190908,18260,996020,364272,950592,318084,45428,46188,520908,360280,1266804,136912,556,1450072,20290424
2024-11-20 06:24:23,1858332,45536,544,190916,18260,996448,364240,951008,318016,45440,46224,520908,360296,1267168,136756,556,1450072,20290528
2024-11-20 06:24:26,1858332,44840,544,190916,18260,996988,364240,951548,318016,45440,46224,520908,360296,1267692,136728,556,1450072,20290528
2024-11-20 06:24:28,1858332,45048,552,190916,18260,996964,364244,951524,318012,45440,46232,520908,360296,1267564,136756,556,1450072,20290460
2024-11-20 06:24:31,1858332,44936,552,190916,18260,997228,364244,951788,318012,45440,46232,520908,360296,1267804,136940,556,1450072,20290656
2024-11-20 06:24:33,1858332,44680,552,190916,18260,997096,364132,951656,317900,45440,46232,520908,360296,1268016,136572,556,1450072,20290416
2024-11-20 06:24:36,1858332,44580,552,190916,18260,997312,364132,951872,317900,45440,46232,520908,360296,1267988,136940,556,1450072,20290516
2024-11-20 06:24:38,1858332,44028,552,190916,18260,997856,364132,952416,317900,45440,46232,520908,360296,1268228,136708,556,1450072,20290584
2024-11-20 06:24:41,1858332,43440,552,190916,18260,997984,364132,952544,317900,45440,46232,520908,360296,1268404,136948,556,1450072,20290608
2024-11-20 06:24:43,1858332,43532,552,190916,18260,998036,364132,952596,317900,45440,46232,520908,360296,1268628,136844,556,1450072,20290500
2024-11-20 06:24:46,1858332,43292,552,190916,18260,998188,364136,952748,317904,45440,46232,520908,360300,1268564,136764,556,1450072,20290548
2024-11-20 06:24:48,1858332,43072,552,190916,18260,998448,364136,953008,317904,45440,46232,520908,360344,1268868,136948,556,1450072,20290540
2024-11-20 06:24:51,1858332,43208,552,190916,18260,998404,364136,952964,317904,45440,46232,520908,360344,1269124,136580,556,1450072,20290460
2024-11-20 06:24:53,1858332,42972,552,190916,18260,998628,364136,953188,317904,45440,46232,520908,360344,1269204,136848,556,1450072,20290544
2024-11-20 06:24:55,1858332,42824,552,191016,18260,998728,364192,953288,317904,45440,46288,520908,360344,1269448,136772,556,1450072,20290524
2024-11-20 06:24:58,1858332,42072,552,191016,18260,999132,364236,953692,317904,45440,46332,520908,360344,1269660,136856,556,1450072,20290548
2024-11-20 06:25:00,1858332,42100,552,191016,18260,999224,364208,953784,317876,45440,46332,520908,360344,1269836,136772,556,1450072,20290408
2024-11-20 06:25:03,1858332,41968,552,191016,18260,999708,364208,954268,317876,45440,46332,520908,360344,1270324,136772,556,1450072,20290480
2024-11-20 06:25:05,1858332,41972,552,191016,18260,999840,364208,954400,317876,45440,46332,520908,360344,1270176,136772,556,1450072,20290512
2024-11-20 06:25:08,1858332,41640,552,191016,18260,999904,364212,954464,317880,45440,46332,520908,360348,1270564,136588,556,1450072,20290464
2024-11-20 06:25:10,1858332,41588,552,191016,18260,1000152,364184,954712,317852,45440,46332,520908,360348,1270832,136720,556,1450072,20290484
2024-11-20 06:25:13,1858332,37828,552,192412,18260,1002540,365520,957100,317852,45440,47668,520908,360348,1273308,137176,556,1450072,20291856
2024-11-20 06:25:15,1858332,37464,552,192412,18260,1002812,365580,957372,317852,45440,47728,520908,360348,1273504,137088,556,1450072,20291956
2024-11-20 06:25:18,1858332,40116,564,189404,18488,1003260,362248,956664,318724,46596,43524,520908,359848,1273528,136584,612,1450072,20291900
2024-11-20 06:25:20,1858332,40384,564,189408,18488,1003216,362236,956604,318728,46612,43508,520908,359848,1273448,136216,612,1450072,20292048
2024-11-20 06:25:23,1858332,37348,564,191720,18548,1003884,364628,957272,318808,46612,45820,520908,359868,1274040,136812,612,1450072,20292204
2024-11-20 06:25:26,1858332,37188,564,191720,18548,1004040,364628,957428,318808,46612,45820,520908,359868,1274396,136864,612,1450072,20291976
2024-11-20 06:25:28,1858332,36992,564,191720,18548,1004500,364628,957888,318808,46612,45820,520908,359868,1274720,136832,612,1450072,20291836
2024-11-20 06:25:31,1858332,37124,564,191720,18548,1004400,364628,957788,318808,46612,45820,520908,359868,1274720,136812,612,1450072,20291928
2024-11-20 06:25:33,1858332,36992,564,191720,18548,1004832,364504,958220,318684,46612,45820,520908,359868,1274940,136828,612,1450072,20291936
2024-11-20 06:25:36,1858332,40932,564,189880,18548,1002256,362548,955272,319148,46984,43400,520908,359076,1271620,135348,612,1450072,20292096
2024-11-20 06:25:39,1858332,46396,564,189728,18548,996776,362452,949736,319052,47040,43400,520908,359076,1266720,135360,612,1450072,20292148
2024-11-20 06:25:41,1858332,46312,564,189728,18548,997304,362452,950264,319052,47040,43400,520908,359076,1267400,135380,612,1450072,20292004
2024-11-20 06:25:43,1858332,46340,564,189728,18548,997584,362452,950544,319052,47040,43400,520908,359076,1267772,135176,612,1450072,20291788
2024-11-20 06:25:46,1858332,45876,564,189728,18548,997764,362452,950724,319052,47040,43400,520908,359076,1267800,135360,612,1450072,20291784
2024-11-20 06:25:48,1858332,45628,564,189728,18548,997668,362452,950628,319052,47040,43400,520908,359076,1267896,135380,612,1450072,20292068
2024-11-20 06:25:51,1858332,45628,564,189728,18548,997668,362452,950628,319052,47040,43400,520908,359076,1267740,135176,612,1450072,20292188
2024-11-20 06:25:53,1858332,45512,564,189728,18548,998136,362452,951096,319052,47040,43400,520908,359076,1268096,135380,612,1450072,20291960
2024-11-20 06:25:56,1858332,45748,564,189728,18548,998236,362452,951196,319052,47040,43400,520908,359076,1268432,135176,612,1450072,20292060
2024-11-20 06:25:58,1858332,44848,564,189728,18548,998708,362452,951668,319052,47040,43400,520908,359076,1268736,135360,612,1450072,20291996
2024-11-20 06:26:01,1858332,44428,564,189728,18552,999468,362460,952428,319060,47040,43400,520908,359132,1269556,135300,612,1450072,20292108
2024-11-20 06:26:04,1858332,44052,564,189728,18552,999356,362460,952316,319060,47040,43400,520908,359132,1269508,135360,612,1450072,20292036
2024-11-20 06:26:06,1858332,44424,564,189728,18552,999456,362460,952416,319060,47040,43400,520908,359132,1269564,135380,612,1450072,20291876
2024-11-20 06:26:08,1858332,44196,564,189728,18552,999388,362460,952348,319060,47040,43400,520908,359132,1269616,135360,612,1450072,20291920
2024-11-20 06:26:11,1858332,43952,564,189728,18552,999652,362460,952612,319060,47040,43400,520908,359132,1269672,135300,612,1450072,20292100
2024-11-20 06:26:14,1858332,44128,564,189752,18552,999812,362484,952772,319060,47040,43424,520908,359132,1270084,135364,612,1450072,20292052
2024-11-20 06:26:17,1858332,42508,564,190424,18552,1000584,363156,953544,319060,47040,44096,520908,359132,1270816,135548,612,1450072,20292152
2024-11-20 06:26:19,1858332,43476,564,190424,18552,1000708,361848,953668,317752,47040,44096,520908,359132,1269300,135516,612,1450072,20292052
2024-11-20 06:26:22,1858332,43564,564,190424,18552,1000724,361848,953684,317752,47040,44096,520908,359132,1269512,135496,612,1450072,20291868
2024-11-20 06:26:24,1858332,43540,564,190424,18552,1000820,361848,953780,317752,47040,44096,520908,359132,1269460,135388,612,1450072,20291964
2024-11-20 06:26:27,1858332,43140,564,190424,18552,1000876,361848,953836,317752,47040,44096,520908,359136,1269792,135496,612,1450072,20291964
2024-11-20 06:26:30,1858332,43260,564,190424,18552,1001324,361852,954284,317756,47040,44096,520908,359136,1270112,135496,612,1450072,20292004
2024-11-20 06:26:32,1858332,43088,564,190424,18552,1001572,361852,954532,317756,47040,44096,520908,359136,1270264,135516,612,1450072,20291992
2024-11-20 06:26:35,1858332,43052,564,190424,18552,1001564,361852,954524,317756,47040,44096,520908,359136,1270428,135496,612,1450072,20292096
2024-11-20 06:26:37,1858332,42480,564,190424,18552,1001808,361852,954768,317756,47040,44096,520908,359136,1270532,135516,612,1450072,20292008
2024-11-20 06:26:40,1858332,42704,564,190424,18552,1002212,361852,955172,317756,47040,44096,520908,359136,1270792,135496,612,1450072,20291996
2024-11-20 06:26:43,1858332,41772,564,190424,18552,1002520,361852,955480,317756,47040,44096,520908,359136,1271208,135716,612,1450072,20291960
2024-11-20 06:26:45,1858332,41516,564,190424,18552,1002980,361852,955940,317756,47040,44096,520908,359136,1271764,135516,612,1450072,20291868
2024-11-20 06:26:48,1858332,40264,564,190424,18552,1003980,361852,956940,317756,47040,44096,520908,359136,1272652,135316,612,1450072,20291972
2024-11-20 06:26:51,1858332,45796,564,190424,18552,998140,361852,951100,317756,47040,44096,520908,359260,1266828,135552,612,1450072,20292052
2024-11-20 06:26:53,1858332,46344,564,190424,18552,998044,361856,951004,317760,47040,44096,520908,359264,1266760,135520,612,1450072,20292044
2024-11-20 06:26:56,1858332,46160,564,190424,18552,998360,361856,951320,317760,47040,44096,520908,359312,1266876,135500,612,1450072,20292164
2024-11-20 06:26:58,1858332,45916,564,190424,18552,998668,361840,951628,317744,47040,44096,520908,359312,1267384,135520,612,1450072,20292032
2024-11-20 06:27:00,1858332,45720,564,190424,18552,998956,361840,951916,317744,47040,44096,520908,359312,1267628,135500,612,1450072,20292024
2024-11-20 06:27:03,1858332,45852,564,190424,18552,998968,361840,951928,317744,47040,44096,520908,359312,1267848,135520,612,1450072,20292036
2024-11-20 06:27:06,1858332,45608,564,190424,18552,999112,361840,952072,317744,47040,44096,520908,359312,1267996,135316,612,1450072,20291904
2024-11-20 06:27:08,1858332,45280,564,190424,18552,999256,361840,952216,317744,47040,44096,520908,359312,1268140,135524,612,1450072,20291972
2024-11-20 06:27:10,1858332,45164,564,190424,18552,999300,361840,952260,317744,47040,44096,520908,359312,1267940,135504,612,1450072,20291996
2024-11-20 06:27:13,1858332,44720,564,190424,18552,999672,361840,952632,317744,47040,44096,520908,359312,1268396,135504,612,1450072,20292032
2024-11-20 06:27:15,1858332,44664,564,190424,18552,999820,361840,952780,317744,47040,44096,520908,359312,1268780,135504,612,1450072,20292104
2024-11-20 06:27:18,1858332,44348,564,190424,18552,1000140,361840,953100,317744,47040,44096,520908,359312,1268660,135504,612,1450072,20292028
2024-11-20 06:27:20,1858332,44352,564,190424,18552,1000584,361840,953544,317744,47040,44096,520908,359312,1269344,135492,612,1450072,20292032
2024-11-20 06:27:23,1858332,44048,564,190424,18552,1000668,361840,953628,317744,47040,44096,520908,359312,1269216,135320,612,1450072,20292044
2024-11-20 06:27:25,1858332,43888,564,190424,18552,1001068,361844,954028,317748,47040,44096,520908,359316,1269924,135524,612,1450072,20292068
2024-11-20 06:27:28,1858332,43900,564,190424,18552,1001256,361844,954216,317748,47040,44096,520908,359316,1269996,135504,612,1450072,20292192
2024-11-20 06:27:30,1858332,43700,564,190424,18552,1001444,361844,954404,317748,47040,44096,520908,359316,1270320,135440,612,1450072,20292108
2024-11-20 06:27:33,1858332,43128,564,190424,18552,1001600,361844,954560,317748,47040,44096,520908,359316,1270388,135504,612,1450072,20292024
2024-11-20 06:27:35,1858332,43384,564,190424,18552,1001620,361844,954580,317748,47040,44096,520908,359316,1270392,135504,612,1450072,20291916
2024-11-20 06:27:38,1858332,42444,564,190432,18544,1002012,361844,954972,317748,47040,44096,520908,359324,1270772,135492,612,1450072,22037256
2024-11-20 06:27:41,1858332,36760,572,190888,18544,1006836,362328,959796,317768,47040,44560,520908,359400,1275824,140168,612,1450072,22213400
2024-11-20 06:27:43,1858332,36572,592,188548,18544,1007028,361892,960036,319596,46992,42296,520908,359124,1278132,142024,612,1450072,22213060
2024-11-20 06:27:46,1858332,35588,600,188836,18544,1008192,362220,961228,319600,46964,42620,520908,359132,1279032,143008,612,1450072,22213168
2024-11-20 06:27:49,1858332,35080,600,188836,18544,1008520,362220,961552,319604,46968,42616,520908,359132,1279524,142964,612,1450072,22213224
2024-11-20 06:27:51,1858332,41344,608,188836,18544,1002068,362232,955100,319608,46968,42624,520908,359208,1273212,142028,612,1450072,22213144
2024-11-20 06:27:53,1858332,40340,608,189628,18544,1002124,363016,955156,319608,46968,43408,520908,359208,1273176,142248,612,1450072,22213148
2024-11-20 06:27:56,1858332,40004,608,189632,18540,1002556,363024,955588,319608,46968,43416,520908,359212,1273452,142248,612,1450072,22213104
2024-11-20 06:27:58,1858332,39448,608,189628,18540,1002704,363024,955736,319608,46968,43416,520908,359212,1273780,142252,612,1450072,22205100
2024-11-20 06:28:01,1858332,40084,608,189628,18540,1002636,363024,955668,319608,46968,43416,520908,359212,1273984,142252,612,1450072,22213228
2024-11-20 06:28:03,1858332,39924,608,189628,18540,1002872,363024,955904,319608,46968,43416,520908,359212,1274032,142068,612,1450072,22213056
2024-11-20 06:28:06,1858332,39772,608,189628,18540,1003536,363024,956568,319608,46968,43416,520908,359212,1274380,142260,612,1450072,22213200
2024-11-20 06:28:09,1858332,39368,608,189628,18540,1003656,363024,956688,319608,46968,43416,520908,359212,1274684,142076,612,1450072,22213156
2024-11-20 06:28:11,1858332,39116,608,189628,18540,1004084,363020,957116,319604,46968,43416,520908,359212,1275044,142200,612,1450072,22213112
2024-11-20 06:28:14,1858332,39368,608,189628,18540,1003896,363020,956928,319604,46968,43416,520908,359212,1274764,142260,612,1450072,22212960
2024-11-20 06:28:16,1858332,38760,608,189628,18540,1004244,363016,957276,319600,46968,43416,520908,359212,1275172,142200,612,1450072,22213044
2024-11-20 06:28:19,1858332,38952,608,189628,18540,1004244,363016,957276,319600,46968,43416,520908,359212,1275072,142260,612,1450072,22213120
2024-11-20 06:28:21,1858332,38668,608,189628,18540,1004528,363016,957560,319600,46968,43416,520908,359212,1275476,142200,612,1450072,22213076
2024-11-20 06:28:24,1858332,38708,608,189628,18540,1004416,363016,957448,319600,46968,43416,520908,359212,1275384,142076,612,1450072,22213216
2024-11-20 06:28:26,1858332,38636,608,189628,18540,1004572,363016,957604,319600,46968,43416,520908,359212,1275520,142260,612,1450072,22213128
2024-11-20 06:28:29,1858332,38576,608,189628,18540,1005040,363016,958072,319600,46968,43416,520908,359212,1275872,142076,612,1450072,22213156
2024-11-20 06:28:31,1858332,38296,608,189628,18540,1005224,363012,958256,319596,46968,43416,520908,359212,1276168,142248,612,1450072,22213124
2024-11-20 06:28:33,1858332,36112,608,191512,18552,1005348,364920,958380,319632,46968,45288,520908,359248,1276328,142684,612,1450072,22213252
2024-11-20 06:28:36,1858332,43840,600,190924,18552,999932,363400,953712,317948,46220,45452,520908,358952,1269848,136220,612,1450072,20291828
2024-11-20 06:28:39,1858332,43756,600,190924,18552,1000296,363032,953708,317948,46588,45084,520908,358952,1269624,136016,612,1450072,20291912
2024-11-20 06:28:41,1858332,43564,600,190924,18552,1000548,363032,953960,317948,46588,45084,520908,358952,1269924,136220,612,1450072,20292016
2024-11-20 06:28:44,1858332,43668,600,190924,18552,1000580,363032,953992,317948,46588,45084,520908,358952,1270076,136200,612,1450072,20292004
2024-11-20 06:28:46,1858332,43048,600,190924,18552,1001068,363036,954480,317952,46588,45084,520908,358956,1270576,136200,612,1450072,20292028
2024-11-20 06:28:49,1858332,42980,600,190924,18552,1001116,363036,954528,317952,46588,45084,520908,358956,1270448,136208,612,1450072,20292104
2024-11-20 06:28:51,1858332,42604,600,190924,18552,1001212,363036,954624,317952,46588,45084,520908,358956,1270588,136200,612,1450072,20291860
2024-11-20 06:28:54,1858332,43008,600,190924,18552,1001328,363036,954740,317952,46588,45084,520908,358956,1270668,136172,612,1450072,20291876
2024-11-20 06:28:56,1858332,42580,600,190924,18552,1001628,363036,955040,317952,46588,45084,520908,358960,1270964,136016,612,1450072,20291960
2024-11-20 06:28:59,1858332,42752,600,190924,18552,1001540,363036,954952,317952,46588,45084,520908,358960,1270960,136220,612,1450072,20292092
2024-11-20 06:29:01,1858332,42520,600,190924,18552,1002092,363036,955504,317952,46588,45084,520908,358960,1271596,136200,612,1450072,20292048
2024-11-20 06:29:04,1858332,41932,600,190924,18552,1001972,363036,955384,317952,46588,45084,520908,358960,1271596,136016,612,1450072,20292016
2024-11-20 06:29:07,1858332,41752,600,190924,18552,1002752,363036,956164,317952,46588,45084,520908,358988,1272012,136200,612,1450072,20292012
2024-11-20 06:29:09,1858332,47632,600,190924,18552,996064,363012,949476,317928,46588,45084,520908,358988,1265416,136224,612,1450072,20291964
2024-11-20 06:29:12,1858332,47652,600,190924,18552,996380,363012,949792,317928,46588,45084,520908,358988,1265876,136200,612,1450072,20292016
2024-11-20 06:29:14,1858332,48224,600,190924,18552,996028,363008,949440,317924,46588,45084,520908,358988,1265728,136068,612,1450072,20291888
2024-11-20 06:29:17,1858332,47692,600,190924,18552,996508,363004,949920,317920,46588,45084,520908,358988,1265904,136220,612,1450072,20292024
2024-11-20 06:29:20,1858332,47300,600,190924,18552,996828,363004,950240,317920,46588,45084,520908,358988,1266348,136200,612,1450072,20292052
2024-11-20 06:29:22,1858332,47200,600,190924,18552,996984,363004,950396,317920,46588,45084,520908,358988,1266492,136200,612,1450072,20292056
2024-11-20 06:29:24,1858332,46528,600,190924,18552,997568,363000,950980,317916,46588,45084,520908,358988,1267076,136200,612,1450072,20292112
2024-11-20 06:29:27,1858332,45888,600,190924,18552,998476,363000,951888,317916,46588,45084,520908,358988,1267820,136140,612,1450072,20292096
2024-11-20 06:29:29,1858332,45548,600,190924,18552,998776,363000,952188,317916,46588,45084,520908,358988,1268392,136200,612,1450072,20292120
2024-11-20 06:29:32,1858332,45156,600,190924,18552,999128,363000,952540,317916,46588,45084,520908,358988,1268676,136204,612,1450072,20291944
2024-11-20 06:29:34,1858332,45208,600,190924,18552,999164,363000,952576,317916,46588,45084,520908,358988,1268632,136204,612,1450072,20292068
2024-11-20 06:29:37,1858332,44784,600,190924,18552,999552,363000,952964,317916,46588,45084,520908,358988,1268844,136144,612,1450072,20291908
2024-11-20 06:29:40,1858332,44764,600,190924,18552,999420,363000,952832,317916,46588,45084,520908,358988,1268708,136020,612,1450072,20292000
2024-11-20 06:29:42,1858332,44432,600,190924,18552,999888,363000,953300,317916,46588,45084,520908,358988,1269224,136232,612,1450072,20292040
2024-11-20 06:29:45,1858332,44212,600,190924,18552,1000164,363000,953576,317916,46588,45084,520908,358988,1269468,136204,612,1450072,20292140
2024-11-20 06:29:47,1858332,43872,600,190924,18552,1000612,363000,954024,317916,46588,45084,520908,358988,1270052,136172,612,1450072,20292064
2024-11-20 06:29:50,1858332,43468,600,190924,18552,1000832,363000,954244,317916,46588,45084,520908,358988,1270364,136388,612,1450072,20291932
2024-11-20 06:29:52,1858332,43284,600,190924,18552,1001024,363000,954436,317916,46588,45084,520908,358988,1270432,136208,612,1450072,20292016
2024-11-20 06:29:55,1858332,40576,600,193228,18556,1001616,365308,955028,317920,46588,47388,520908,358988,1271228,136264,612,1450072,20291972
2024-11-20 06:29:57,1858332,40432,600,193228,18556,1001808,365308,955220,317920,46588,47388,520908,359036,1271076,136264,612,1450072,20292076
2024-11-20 06:30:00,1858332,39760,600,193228,18556,1002340,365308,955752,317920,46588,47388,520908,359036,1271952,136320,612,1450072,20292060
2024-11-20 06:30:03,1858332,45384,600,193228,18556,995956,365308,949368,317920,46588,47388,520908,359056,1265460,136264,612,1450072,20292172
2024-11-20 06:30:05,1858332,45248,600,193228,18556,996380,365312,949792,317924,46588,47388,520908,359056,1265872,136312,612,1450072,20291920
2024-11-20 06:30:08,1858332,45308,600,193228,18556,996528,365312,949940,317924,46588,47388,520908,359056,1265856,136252,612,1450072,20291968
2024-11-20 06:30:10,1858332,44992,600,193228,18556,996772,365312,950184,317924,46588,47388,520908,359056,1266168,136080,612,1450072,20292168
2024-11-20 06:30:13,1858332,45124,600,193228,18556,996680,365312,950092,317924,46588,47388,520908,359056,1266032,136284,612,1450072,20292008
2024-11-20 06:30:16,1858332,44512,600,193228,18556,997072,365312,950484,317924,46588,47388,520908,359056,1266664,136264,612,1450072,20291928
2024-11-20 06:30:18,1858332,44612,600,193228,18556,997464,365312,950876,317924,46588,47388,520908,359056,1267012,136284,612,1450072,20291992
2024-11-20 06:30:21,1858332,44168,600,193396,18556,997668,365480,951080,317924,46588,47556,520908,359056,1267104,136312,612,1450072,20292076
2024-11-20 06:30:24,1858332,44040,600,193396,18556,997580,365480,950992,317924,46588,47556,520908,359056,1267052,136104,612,1450072,20292136
2024-11-20 06:30:26,1858332,43960,600,193396,18556,997968,365480,951380,317924,46588,47556,520908,359056,1267308,136288,612,1450072,20292108
2024-11-20 06:30:29,1858332,43920,600,193396,18556,997632,365480,951044,317924,46588,47556,520908,359056,1267348,136288,612,1450072,20291852
2024-11-20 06:30:31,1858332,43308,600,193396,18556,998152,365480,951564,317924,46588,47556,520908,359056,1267468,136288,612,1450072,20292088
2024-11-20 06:30:34,1858332,43244,600,193396,18556,998520,365480,951932,317924,46588,47556,520908,359056,1267984,136288,612,1450072,20292072
2024-11-20 06:30:36,1858332,43284,600,193396,18556,998448,365480,951860,317924,46588,47556,520908,359056,1267872,136152,612,1450072,20291972
2024-11-20 06:30:39,1858332,43220,600,193396,18556,998568,365480,951980,317924,46588,47556,520908,359056,1267936,136316,612,1450072,20292020
2024-11-20 06:30:42,1858332,43016,600,193396,18556,998708,365480,952120,317924,46588,47556,520908,359056,1268044,136288,612,1450072,20292136
2024-11-20 06:30:45,1858332,42708,600,193396,18556,999120,365480,952532,317924,46588,47556,520908,359056,1268300,136288,612,1450072,20292052
2024-11-20 06:30:47,1858332,42672,600,193396,18556,999024,365480,952436,317924,46588,47556,520908,359056,1268420,136336,612,1450072,20292040
2024-11-20 06:30:50,1858332,42436,600,193396,18556,999172,365480,952584,317924,46588,47556,520908,359056,1268520,136288,612,1450072,20291928
2024-11-20 06:30:52,1858332,42440,600,193396,18556,999444,365480,952856,317924,46588,47556,520908,359056,1268800,136156,612,1450072,20291980
2024-11-20 06:30:55,1858332,41832,600,193396,18556,999872,365480,953284,317924,46588,47556,520908,359056,1269284,136308,612,1450072,20292156
2024-11-20 06:30:58,1858332,41696,600,193396,18556,999876,365480,953288,317924,46588,47556,520908,359056,1269216,136104,612,1450072,20292124
2024-11-20 06:31:00,1858332,41376,600,193396,18556,1000252,365480,953664,317924,46588,47556,520908,359056,1269500,136156,612,1450072,20292008
2024-11-20 06:31:03,1858332,41276,600,193396,18556,1000320,365480,953732,317924,46588,47556,520908,359056,1269744,136308,612,1450072,20291904
2024-11-20 06:31:06,1858332,41204,600,193396,18556,1000344,365480,953756,317924,46588,47556,520908,359056,1269784,136288,612,1450072,20291928
2024-11-20 06:31:08,1858332,40484,600,193396,18556,1000868,365480,954280,317924,46588,47556,520908,359056,1270420,136308,612,1450072,20291904
2024-11-20 06:31:11,1858332,40260,600,193396,18556,1000908,365480,954320,317924,46588,47556,520908,359056,1270288,136308,612,1450072,20291976
2024-11-20 06:31:13,1858332,40596,600,193396,18556,1001016,365480,954428,317924,46588,47556,520908,359056,1270512,136288,612,1450072,20291800
2024-11-20 06:31:16,1858332,40204,600,193396,18556,1001148,365480,954560,317924,46588,47556,520908,359056,1270580,136104,612,1450072,20291980
2024-11-20 06:31:18,1858332,39876,600,193396,18556,1001212,365480,954624,317924,46588,47556,520908,359056,1270600,136300,612,1450072,20292060
2024-11-20 06:31:21,1858332,39708,600,193396,18556,1001668,365480,955080,317924,46588,47556,520908,359056,1271092,136308,612,1450072,20292068
2024-11-20 06:31:24,1858332,39088,600,193396,18556,1001956,365480,955368,317924,46588,47556,520908,359056,1271260,136288,612,1450072,20291968
2024-11-20 06:31:26,1858332,39396,600,193396,18556,1002112,365480,955524,317924,46588,47556,520908,359056,1271532,136300,612,1450072,20292032
2024-11-20 06:31:29,1858332,39272,600,193396,18556,1002068,365480,955480,317924,46588,47556,520908,359056,1271384,136288,612,1450072,20291996
2024-11-20 06:31:31,1858332,39076,600,193396,18556,1002456,365480,955868,317924,46588,47556,520908,359056,1271868,136332,612,1450072,20291976
2024-11-20 06:31:34,1858332,38812,600,193396,18556,1002716,365480,956128,317924,46588,47556,520908,359056,1271912,136104,612,1450072,20292132
2024-11-20 06:31:36,1858332,39000,600,193396,18556,1002588,365480,956000,317924,46588,47556,520908,359056,1271980,136156,612,1450072,20292156
2024-11-20 06:31:39,1858332,38652,600,193396,18556,1002660,365480,956072,317924,46588,47556,520908,359056,1272008,136308,612,1450072,20291920
2024-11-20 06:31:42,1858332,44584,600,193396,18556,996508,365476,949920,317920,46588,47556,520908,359056,1266048,136288,612,1450072,20292068
2024-11-20 06:31:44,1858332,44892,600,193396,18556,996492,365476,949904,317920,46588,47556,520908,359056,1265960,135948,612,1450072,20291996
2024-11-20 06:31:47,1858332,44876,600,193396,18556,996940,365476,950352,317920,46588,47556,520908,359056,1266220,136288,612,1450072,20292012
2024-11-20 06:31:49,1858332,44204,600,193396,18556,997192,365476,950604,317920,46588,47556,520908,359056,1266604,136288,612,1450072,20291904
2024-11-20 06:31:52,1858332,44228,600,193396,18556,997128,365476,950540,317920,46588,47556,520908,359056,1266608,136288,612,1450072,20292128
2024-11-20 06:31:54,1858332,44140,600,193396,18556,997500,365476,950912,317920,46588,47556,520908,359056,1266952,136308,612,1450072,20291988
2024-11-20 06:31:57,1858332,43956,600,193396,18556,997612,365476,951024,317920,46588,47556,520908,359056,1266924,136288,612,1450072,20292096
2024-11-20 06:31:59,1858332,43648,600,193396,18556,997868,365476,951280,317920,46588,47556,520908,359056,1267400,136308,612,1450072,20292112
2024-11-20 06:32:02,1858332,43728,600,193396,18556,998016,365476,951428,317920,46588,47556,520908,359056,1267444,136104,612,1450072,20292048
2024-11-20 06:32:04,1858332,42760,600,193396,18556,998904,365476,952316,317920,46588,47556,520908,359056,1268316,136288,612,1450072,20291960
2024-11-20 06:32:07,1858332,42000,600,193396,18556,999680,365476,953092,317920,46588,47556,520908,359060,1269160,136288,612,1450072,20291944
2024-11-20 06:32:10,1858332,41620,600,193396,18556,1000236,365480,953648,317924,46588,47556,520908,359060,1269788,136300,612,1450072,20291916
2024-11-20 06:32:12,1858332,41620,600,193396,18556,1000120,365480,953532,317924,46588,47556,520908,359060,1269504,136352,612,1450072,20292164
2024-11-20 06:32:15,1858332,41272,600,193396,18556,1000008,365480,953420,317924,46588,47556,520908,359060,1269420,136296,612,1450072,20292076
2024-11-20 06:32:17,1858332,41392,600,193396,18556,1000400,365480,953812,317924,46588,47556,520908,359060,1269932,136216,612,1450072,20292044
2024-11-20 06:32:20,1858332,40936,600,193396,18556,1000696,365480,954108,317924,46588,47556,520908,359060,1270112,136308,612,1450072,20291916
2024-11-20 06:32:22,1858332,40956,600,193396,18556,1000584,365480,953996,317924,46588,47556,520908,359060,1270088,136308,612,1450072,20291944
2024-11-20 06:32:25,1858332,40256,600,193396,18556,1000908,365480,954320,317924,46588,47556,520908,359060,1270252,136248,612,1450072,20291968
2024-11-20 06:32:28,1858332,40460,600,193396,18556,1001292,365480,954704,317924,46588,47556,520908,359060,1270852,136308,612,1450072,20292172
2024-11-20 06:32:30,1858332,39972,600,193396,18556,1001448,365480,954860,317924,46588,47556,520908,359060,1270920,136348,612,1450072,20291860
2024-11-20 06:32:33,1858332,39536,600,193396,18552,1001788,365480,955200,317924,46588,47556,520908,359064,1271240,136308,612,1450072,20292072
2024-11-20 06:32:35,1858332,39768,600,193396,18552,1002208,365480,955620,317924,46588,47556,520908,359064,1271328,136308,612,1450072,20291928
2024-11-20 06:32:38,1858332,39140,600,193396,18552,1002576,365480,955988,317924,46588,47556,520908,359064,1271904,136248,612,1450072,20292096
2024-11-20 06:32:40,1858332,38728,600,193396,18552,1002600,365480,956012,317924,46588,47556,520908,359064,1271948,136308,612,1450072,20291948
2024-11-20 06:32:43,1858332,44864,600,193396,18552,996296,365480,949708,317924,46588,47556,520908,359088,1265724,136356,612,1450072,20291996
2024-11-20 06:32:46,1858332,44476,600,193396,18552,996596,365480,950008,317924,46588,47556,520908,359088,1266088,136308,612,1450072,20292060
2024-11-20 06:32:48,1858332,44380,600,193396,18552,996524,365480,949936,317924,46588,47556,520908,359088,1265960,136124,612,1450072,20292024
2024-11-20 06:32:51,1858332,44376,600,193396,18552,996784,365480,950196,317924,46588,47556,520908,359088,1266116,136308,612,1450072,20292040
2024-11-20 06:32:54,1858332,44676,600,193396,18552,996784,365480,950196,317924,46588,47556,520908,359088,1266124,136124,612,1450072,20291936
2024-11-20 06:32:56,1858332,44456,600,193396,18552,997252,365480,950664,317924,46588,47556,520908,359088,1266660,136308,612,1450072,20291960
2024-11-20 06:32:59,1858332,44316,600,193396,18552,997644,365480,951056,317924,46588,47556,520908,359088,1267020,136328,612,1450072,20292036
2024-11-20 06:33:02,1858332,43804,600,193396,18552,997780,365480,951192,317924,46588,47556,520908,359088,1267128,136308,612,1450072,20292164
2024-11-20 06:33:04,1858332,43888,600,193396,18552,997836,365480,951248,317924,46588,47556,520908,359088,1267360,136168,612,1450072,20291940
2024-11-20 06:33:06,1858332,43408,600,193396,18552,998080,365480,951492,317924,46588,47556,520908,359092,1267568,136308,612,1450072,20292084
2024-11-20 06:33:09,1858332,43404,600,193396,18552,998276,365484,951688,317928,46588,47556,520908,359092,1267440,136308,612,1450072,20292140
2024-11-20 06:33:12,1858332,43448,600,193396,18552,998204,365484,951616,317928,46588,47556,520908,359092,1267632,136308,612,1450072,20291992
2024-11-20 06:33:14,1858332,43072,600,193396,18552,998564,365484,951976,317928,46588,47556,520908,359092,1267908,136328,612,1450072,20292000
2024-11-20 06:33:17,1858332,42740,636,193388,18552,998880,365488,952284,317936,46596,47552,520908,359100,1268184,136132,612,1450072,20292080
2024-11-20 06:33:19,1858332,42440,704,193460,18556,998940,365628,952316,317940,46624,47688,520908,359100,1268360,136372,612,1450072,20292124
2024-11-20 06:33:22,1858332,42108,704,193460,18556,999236,365628,952612,317940,46624,47688,520908,359100,1268520,136320,612,1450072,20292000
2024-11-20 06:33:24,1858332,41864,712,193452,18556,999196,365628,952572,317940,46624,47688,520908,359100,1268492,136336,612,1450072,20292004
2024-11-20 06:33:27,1858332,41648,712,193460,18556,999500,365636,952876,317940,46624,47696,520908,359100,1268804,136320,612,1450072,20292012
2024-11-20 06:33:29,1858332,41660,720,193456,18560,999760,365636,953136,317940,46624,47696,520908,359156,1269268,136356,612,1450072,20292080
2024-11-20 06:33:32,1858332,41140,728,193524,18560,1000196,365772,953568,318000,46628,47772,520908,359160,1269868,136328,612,1450072,20292044
2024-11-20 06:33:34,1858332,41056,728,193524,18560,1000652,365772,954024,318000,46628,47772,520908,359160,1270012,136328,612,1450072,20292044
2024-11-20 06:33:37,1858332,41084,736,193524,18560,1000612,365772,953984,318000,46628,47772,520908,359160,1270176,136328,612,1450072,20291952
2024-11-20 06:33:39,1858332,40832,736,193524,18560,1000736,365780,954108,318000,46628,47780,520908,359160,1270212,136348,612,1450072,20292072
2024-11-20 06:33:42,1858332,40880,736,193524,18560,1000900,365780,954272,318000,46628,47780,520908,359160,1270424,136328,612,1450072,20292128
2024-11-20 06:33:44,1858332,40372,736,193524,18560,1001300,365780,954672,318000,46628,47780,520908,359160,1270748,136268,612,1450072,20292148
2024-11-20 06:33:47,1858332,39828,736,193524,18560,1001444,365780,954816,318000,46628,47780,520908,359160,1270712,136328,612,1450072,20292108
2024-11-20 06:33:49,1858332,39620,736,193524,18560,1001564,365780,954936,318000,46628,47780,520908,359160,1271072,136344,612,1450072,20292004
2024-11-20 06:33:52,1858332,39272,736,193524,18560,1001824,365780,955196,318000,46628,47780,520908,359160,1271236,136328,612,1450072,20292136
2024-11-20 06:33:54,1858332,39176,736,193524,18560,1001676,365780,955048,318000,46628,47780,520908,359160,1271264,136224,612,1450072,20292236
2024-11-20 06:33:57,1858332,39324,736,193524,18560,1002028,365772,955400,317992,46628,47780,520908,359160,1271560,136328,612,1450072,20292068
2024-11-20 06:33:59,1858332,39028,736,193524,18560,1002348,365772,955720,317992,46628,47780,520908,359160,1271664,136144,612,1450072,20292068
2024-11-20 06:34:02,1858332,38844,736,193524,18560,1002240,365772,955612,317992,46628,47780,520908,359160,1271560,136328,612,1450072,20292192
2024-11-20 06:34:04,1858332,39268,736,193524,18560,1002136,365772,955508,317992,46628,47780,520908,359160,1271516,136328,612,1450072,20291988
2024-11-20 06:34:07,1858332,39116,736,193524,18560,1002660,365772,956032,317992,46628,47780,520908,359164,1272176,136328,612,1450072,20291900
2024-11-20 06:34:09,1858332,38612,736,193524,18560,1003164,365776,956536,317996,46628,47780,520908,359164,1272608,136376,612,1450072,20291944
2024-11-20 06:34:12,1858332,44552,736,193524,18560,996736,365776,950108,317996,46628,47780,520908,359184,1266152,136268,612,1450072,20292056
2024-11-20 06:34:15,1858332,44576,736,193524,18560,996796,365776,950168,317996,46628,47780,520908,359184,1266260,136328,612,1450072,20291944
2024-11-20 06:34:17,1858332,44432,736,193524,18560,996448,365776,949820,317996,46628,47780,520908,359188,1265892,136328,612,1450072,20291980
2024-11-20 06:34:19,1858332,44208,736,193524,18560,996636,365780,950008,318000,46628,47780,520908,359188,1266140,136328,612,1450072,20292076
2024-11-20 06:34:22,1858332,44100,736,193524,18560,997164,365780,950536,318000,46628,47780,520908,359188,1266668,136328,612,1450072,20283752
2024-11-20 06:34:24,1858332,43768,736,193524,18560,997592,365780,950964,318000,46628,47780,520908,359188,1266864,136348,612,1450072,20292008
2024-11-20 06:34:27,1858332,45320,736,193524,18560,996016,365780,949264,318000,46752,47780,520908,359192,1265364,136328,612,1450072,20292044
2024-11-20 06:34:29,1858332,43296,736,193616,18560,998020,365616,951132,318004,46888,47612,520908,359196,1267172,136196,612,1450072,20291984
2024-11-20 06:34:32,1858332,43328,736,193616,18560,997980,365616,951092,318004,46888,47612,520908,359196,1267172,136144,612,1450072,20291876
2024-11-20 06:34:35,1858332,42836,736,193616,18560,998372,365616,951484,318004,46888,47612,520908,359196,1267656,136328,612,1450072,20291772
2024-11-20 06:34:37,1858332,42668,736,193616,18560,998368,365616,951480,318004,46888,47612,520908,359196,1267500,136268,612,1450072,20291884
2024-11-20 06:34:39,1858332,42472,736,193616,18560,998768,365616,951880,318004,46888,47612,520908,359196,1268148,136328,612,1450072,20291960
2024-11-20 06:34:42,1858332,42340,736,193616,18560,999296,365616,952408,318004,46888,47612,520908,359196,1268540,136348,612,1450072,20292024
2024-11-20 06:34:45,1858332,41416,736,193616,18560,1000268,365616,953380,318004,46888,47612,520908,359196,1269332,136328,612,1450072,20291936
2024-11-20 06:34:47,1858332,40168,736,193616,18560,1001144,365616,954256,318004,46888,47612,520908,359196,1270344,136348,612,1450072,20291972
2024-11-20 06:34:50,1858332,39904,736,193616,18560,1001536,365616,954648,318004,46888,47612,520908,359196,1270856,136328,612,1450072,20292096
2024-11-20 06:34:52,1858332,39972,736,193616,18560,1001460,365616,954572,318004,46888,47612,520908,359196,1270720,136372,612,1450072,20291976
2024-11-20 06:34:55,1858332,39728,736,193616,18560,1001972,365616,955084,318004,46888,47612,520908,359196,1271228,136328,612,1450072,20292076
2024-11-20 06:34:58,1858332,39580,736,193616,18560,1001840,365616,954952,318004,46888,47612,520908,359196,1271196,136332,612,1450072,20291960
2024-11-20 06:35:00,1858332,38900,736,193616,18560,1002640,365616,955752,318004,46888,47612,520908,359228,1271896,136332,612,1450072,20291964
2024-11-20 06:35:03,1858332,38244,736,193616,18560,1003648,365576,956760,317964,46888,47612,520908,359228,1272656,136332,612,1450072,20292008
2024-11-20 06:35:05,1858332,44024,736,193616,18560,996848,365576,949960,317964,46888,47612,520908,359228,1266088,136348,612,1450072,20292036
2024-11-20 06:35:08,1858332,44452,736,193616,18560,997564,365576,950676,317964,46888,47612,520908,359228,1266700,136352,612,1450072,20291920
2024-11-20 06:35:11,1858332,44324,736,193616,18560,997520,365576,950632,317964,46888,47612,520908,359228,1266696,136332,612,1450072,20291960
2024-11-20 06:35:13,1858332,44068,736,193616,18560,997500,365576,950612,317964,46888,47612,520908,359228,1266608,136392,612,1450072,20292000
2024-11-20 06:35:16,1858332,43916,736,193616,18560,997556,365576,950668,317964,46888,47612,520908,359228,1266808,136332,612,1450072,20291976
2024-11-20 06:35:18,1858332,43772,736,193616,18560,998228,365576,951340,317964,46888,47612,520908,359228,1267212,136380,612,1450072,20292136
2024-11-20 06:35:21,1858332,43536,736,193616,18560,997972,365576,951084,317964,46888,47612,520908,359228,1267068,136332,612,1450072,20292080
2024-11-20 06:35:23,1858332,43468,736,193616,18560,998356,365576,951468,317964,46888,47612,520908,359228,1267452,136252,612,1450072,20291960
2024-11-20 06:35:26,1858332,42992,736,193616,18560,998420,365576,951532,317964,46888,47612,520908,359228,1267760,136148,612,1450072,20291928
2024-11-20 06:35:28,1858332,42912,736,193616,18560,998584,365576,951696,317964,46888,47612,520908,359228,1267712,136200,612,1450072,20291984
2024-11-20 06:35:31,1858332,42792,736,193616,18560,998744,365576,951856,317964,46888,47612,520908,359228,1267872,136148,612,1450072,20291952
2024-11-20 06:35:33,1858332,42788,736,193616,18560,998896,365576,952008,317964,46888,47612,520908,359228,1267972,136148,612,1450072,20291836
2024-11-20 06:35:35,1858332,45880,732,198040,18188,995248,367464,947988,315944,47260,51520,520908,358480,1261876,136884,612,1450072,20163832
2024-11-20 06:35:38,1858332,45616,732,199024,18200,994540,367800,946844,315604,47696,52196,520908,358480,1260552,134728,612,1450072,20161504
2024-11-20 06:35:40,1858332,45760,732,199024,18200,994900,367812,947204,315604,47696,52208,520908,358480,1260972,134728,612,1450072,20161460
2024-11-20 06:35:42,1858332,45712,732,199024,18200,994840,367808,947140,315604,47700,52204,520908,358480,1260820,134728,612,1450072,20161536
2024-11-20 06:35:44,1858332,44956,732,199024,18200,995048,367808,947348,315604,47700,52204,520908,358480,1261312,134728,612,1450072,20161528
2024-11-20 06:35:46,1858332,45360,732,199024,18200,995096,367808,947396,315604,47700,52204,520908,358480,1261076,134728,612,1450072,20161556
2024-11-20 06:35:48,1858332,45236,732,199024,18204,995088,367832,947388,315628,47700,52204,520908,358500,1261140,134728,612,1450072,20161476
2024-11-20 06:35:50,1858332,44760,732,199024,18204,995272,367832,947572,315628,47700,52204,520908,358500,1261360,134720,612,1450072,20161488
2024-11-20 06:35:52,1858332,44404,732,199024,18204,995536,367832,947836,315628,47700,52204,520908,358500,1261612,134740,612,1450072,20161504
2024-11-20 06:35:55,1858332,44192,732,199024,18204,995812,367832,948112,315628,47700,52204,520908,358500,1261912,134740,612,1450072,20161476
2024-11-20 06:35:57,1858332,46720,708,196216,18092,995276,365216,947576,315896,47700,49320,520908,357916,1261284,134544,612,1450072,20161364
2024-11-20 06:35:59,1858332,46796,708,196224,18092,995316,365092,947556,315772,47760,49320,520908,357916,1261472,134572,612,1450072,20161516
