Timestamp,MemTotal,MemFree,Buffers,Cached,SwapCached,Active,Inactive,Active(anon),Inactive(anon),Active(file),Inactive(file),SwapTotal,SwapFree,AnonPages,Mapped,Shmem,CommitLimit,Committed_AS
2024-11-20 06:39:10,1858332,142128,2336,1188456,17284,147588,1069104,94720,31384,52868,1037720,520908,361660,124492,425028,572,1450072,22169284
2024-11-20 06:39:10,1858332,142128,2336,1188456,17284,147588,1069104,94720,31384,52868,1037720,520908,361660,124492,425028,572,1450072,22169284
2024-11-20 06:39:10,1858332,142128,2336,1188456,17284,147588,1069104,94720,31384,52868,1037720,520908,361660,124492,425028,572,1450072,22169284
2024-11-20 06:39:10,1858332,142128,2336,1188456,17284,147588,1069104,94720,31384,52868,1037720,520908,361660,124492,425028,572,1450072,22169284
2024-11-20 06:39:10,1858332,142128,2336,1188456,17284,147588,1069104,94720,31384,52868,1037720,520908,361660,124492,425028,572,1450072,22169284
2024-11-20 06:39:10,1858332,142128,2336,1188456,17284,147588,1069104,94720,31384,52868,1037720,520908,361660,124492,425028,572,1450072,22169284
2024-11-20 06:39:10,1858332,142128,2336,1188456,17284,147588,1069104,94720,31384,52868,1037720,520908,361660,124492,425028,572,1450072,22169284
2024-11-20 06:39:10,1858332,142128,2336,1188456,17284,147588,1069104,94720,31384,52868,1037720,520908,361660,124492,425028,572,1450072,22169284
2024-11-20 06:39:10,1858332,142128,2336,1188456,17284,147588,1069104,94720,31384,52868,1037720,520908,361660,124492,425028,572,1450072,22169284
2024-11-20 06:39:10,1858332,142128,2336,1188456,17284,147588,1069104,94720,31384,52868,1037720,520908,361660,124492,425028,572,1450072,22169284
2024-11-20 06:39:10,1858332,142128,2336,1188456,17284,147588,1069104,94720,31384,52868,1037720,520908,361660,124492,425028,572,1450072,22169284
2024-11-20 06:39:12,1858332,138604,1076,1215448,17132,629500,620160,100176,33400,529324,586760,520908,361524,131848,786772,572,1450072,22266300
2024-11-20 06:39:14,1858332,137400,1080,1217376,17132,659088,592504,100012,33536,559076,558968,520908,361524,132004,821900,572,1450072,22266152
2024-11-20 06:39:16,1858332,141700,1084,1219628,17140,654640,593940,95072,32864,559568,561076,520908,361620,126324,853108,572,1450072,22266116
2024-11-20 06:39:18,1858332,143116,1004,1218008,17140,654912,592160,95616,32424,559296,559736,520908,361620,126612,888720,572,1450072,22266232
2024-11-20 06:39:21,1858332,141148,1008,1220160,17140,655572,593632,95776,32224,559796,561408,520908,361620,126440,920708,572,1450072,22266332
2024-11-20 06:39:23,1858332,141576,144,1221736,17140,656108,593980,95876,32092,560232,561888,520908,361616,126372,931676,572,1450072,22266224
2024-11-20 06:39:25,1858332,142220,152,1220476,17140,656168,592844,96184,32036,559984,560808,520908,361616,126848,926488,572,1450072,22266296
2024-11-20 06:39:27,1858332,142592,152,1220208,17140,655688,592824,96240,32132,559448,560692,520908,361616,126848,924136,572,1450072,22266308
2024-11-20 06:39:29,1858332,143124,160,1219732,17140,655364,592400,95628,32100,559736,560300,520908,361616,126012,921400,572,1450072,22266316
2024-11-20 06:39:31,1858332,143612,160,1218236,17140,655580,591516,96408,32184,559172,559332,520908,361616,127060,918844,572,1450072,22266304
2024-11-20 06:39:33,1858332,143356,168,1218712,17140,655464,591720,96064,32160,559400,559560,520908,361616,126880,917644,572,1450072,22266100
2024-11-20 06:39:35,1858332,142152,160,1220512,17140,655488,593596,96400,32124,559088,561472,520908,361616,126936,914904,572,1450072,22266196
2024-11-20 06:39:37,1858332,142832,160,1219528,17140,655728,592312,96328,32096,559400,560216,520908,361612,126940,912852,572,1450072,22266072
2024-11-20 06:39:39,1858332,141432,168,1219400,17140,656248,592348,96800,32188,559448,560160,520908,361612,127216,908360,572,1450072,22266196
2024-11-20 06:39:42,1858332,140964,448,1220012,17136,656400,593272,96984,32272,559416,561000,520908,361612,127720,903304,572,1450072,22266460
2024-11-20 06:39:44,1858332,113820,560,1217788,17136,683208,593292,124200,34040,559008,559252,520908,361612,156920,899576,572,1450072,22377292
2024-11-20 06:39:46,1858332,89968,560,1218060,17136,706956,593740,147904,34040,559052,559700,520908,361612,180712,899792,572,1450072,22400644
2024-11-20 06:39:48,1858332,34044,208,998428,17132,827172,535520,353220,110632,473952,424888,520908,361588,462548,773800,572,1450072,23193972
2024-11-20 06:39:50,1858332,32440,104,492072,15924,924600,438828,728916,243108,195684,195720,520908,361356,971668,147912,572,1450072,23193924
2024-11-20 06:39:52,1858332,56952,184,180228,15860,989920,352016,947984,313696,41936,38320,520908,362104,1261412,113580,572,1450072,20274404
2024-11-20 06:39:55,1858332,43640,384,205984,16688,994392,377704,949448,316376,44944,61328,520908,362108,1264768,127468,568,1450072,22195724
2024-11-20 06:39:57,1858332,41068,476,209364,15748,1007796,372832,953276,317656,54520,55176,520908,355776,1269704,135484,564,1450072,24116832
2024-11-20 06:40:00,1858332,46468,356,201308,13856,979848,374680,935668,317180,44180,57500,520908,350436,1251052,125916,556,1450072,20274544
2024-11-20 06:40:02,1858332,45872,356,204660,14316,980440,378804,936112,317868,44328,60936,520908,350744,1252240,126872,556,1450072,20274592
2024-11-20 06:40:04,1858332,43736,388,206384,14384,984136,379780,939192,317880,44944,61900,520908,350572,1255556,131508,560,1450072,22195780
2024-11-20 06:40:06,1858332,34964,392,199704,14132,1000132,372392,954412,317840,45720,54552,520908,350688,1271112,139376,560,1450072,24117592
2024-11-20 06:40:09,1858332,52472,308,176828,13984,987956,351880,946852,315696,41104,36184,520908,350396,1249832,132260,564,1450072,22196608
2024-11-20 06:40:12,1858332,61796,328,181372,14100,974264,356720,933152,315944,41112,40776,520908,350572,1247252,127164,560,1450072,20274376
2024-11-20 06:40:14,1858332,53372,336,189248,14236,974788,364772,933676,316100,41112,48672,520908,350712,1247956,127636,560,1450072,20274400
2024-11-20 06:40:17,1858332,52752,336,189276,14236,975632,364788,934520,316100,41112,48688,520908,350740,1248708,127472,560,1450072,20274484
2024-11-20 06:40:19,1858332,49232,336,192848,14428,974928,368736,933816,316464,41112,52272,520908,351252,1248500,128368,560,1450072,20274508
2024-11-20 06:40:22,1858332,49172,336,193368,14540,975556,369496,934444,316704,41112,52792,520908,351400,1249400,128736,560,1450072,20274240
2024-11-20 06:40:24,1858332,49664,336,192740,15328,975816,370340,934704,318104,41112,52236,520908,352092,1251088,128944,560,1450072,20274408
2024-11-20 06:40:27,1858332,48828,336,192804,15912,976068,370920,934956,318692,41112,52228,520908,352256,1251800,128972,560,1450072,20274388
2024-11-20 06:40:29,1858332,45212,368,193856,17420,980944,374840,939832,321616,41112,53224,520908,354076,1259692,133960,560,1450072,22195756
2024-11-20 06:40:32,1858332,50800,396,194212,17448,977544,375168,935976,321764,41568,53404,520908,354008,1255816,129876,560,1450072,20274532
2024-11-20 06:40:34,1858332,50692,404,194304,17476,977680,375032,936104,321672,41576,53360,520908,354012,1255848,129960,560,1450072,20274316
2024-11-20 06:40:37,1858332,48944,404,194632,18392,978000,377164,936424,323504,41576,53660,520908,354928,1258020,129736,560,1450072,20274220
2024-11-20 06:40:39,1858332,48640,404,194632,18428,978224,377448,936648,323788,41576,53660,520908,355208,1258604,129860,560,1450072,20274360
2024-11-20 06:40:42,1858332,47896,408,196012,18448,978860,377656,937284,323092,41576,54564,520908,355112,1258152,130072,560,1450072,20274324
2024-11-20 06:40:44,1858332,47640,408,197684,18472,979044,379592,937440,322904,41604,56688,520908,355120,1258500,130284,560,1450072,20274304
2024-11-20 06:40:47,1858332,47796,408,197840,18472,979088,379708,937484,322884,41604,56824,520908,355120,1258536,130624,560,1450072,20274340
2024-11-20 06:40:49,1858332,47856,408,197840,18472,979300,379712,937696,322868,41604,56844,520908,355120,1258624,130516,560,1450072,20274312
2024-11-20 06:40:52,1858332,47696,408,198180,18472,979488,380064,937884,322880,41604,57184,520908,355136,1258792,130516,560,1450072,20274400
2024-11-20 06:40:54,1858332,47304,408,198296,18472,979436,380176,937832,322880,41604,57296,520908,355136,1258856,130456,560,1450072,20274240
2024-11-20 06:40:57,1858332,47056,408,198476,18476,979760,380372,938156,322892,41604,57480,520908,355148,1259064,130612,560,1450072,20274308
2024-11-20 06:41:00,1858332,46656,408,198476,18476,979812,380372,938208,322892,41604,57480,520908,355188,1259172,130716,560,1450072,20274368
2024-11-20 06:41:02,1858332,46180,408,198476,18476,980276,380336,938672,322856,41604,57480,520908,355188,1259624,130608,560,1450072,20274296
2024-11-20 06:41:04,1858332,46072,408,198476,18476,980532,380316,938928,322836,41604,57480,520908,355192,1259844,130532,560,1450072,20274360
2024-11-20 06:41:07,1858332,46128,408,198472,18480,980356,380316,938752,322836,41604,57480,520908,355252,1259872,130532,560,1450072,20274268
2024-11-20 06:41:09,1858332,46608,408,197740,18476,980660,379256,939056,322880,41604,56376,520908,355232,1259940,130524,560,1450072,20274252
2024-11-20 06:41:12,1858332,48236,408,196752,18476,980504,378596,938900,322840,41604,55756,520908,355232,1259904,130536,560,1450072,20274364
2024-11-20 06:41:14,1858332,47972,408,196752,18476,980900,378596,939296,322840,41604,55756,520908,355232,1260360,130600,560,1450072,20274112
2024-11-20 06:41:17,1858332,47728,408,196752,18476,980972,378600,939368,322844,41604,55756,520908,355236,1260168,130724,560,1450072,20274364
2024-11-20 06:41:19,1858332,47396,408,196776,18480,981540,378628,939936,322848,41604,55780,520908,355236,1260832,130564,560,1450072,20274412
2024-11-20 06:41:22,1858332,47388,408,196776,18484,981568,378636,939964,322856,41604,55780,520908,355264,1260856,130728,560,1450072,20274208
2024-11-20 06:41:24,1858332,47572,408,196776,18484,981512,378636,939908,322856,41604,55780,520908,355264,1260880,130604,560,1450072,20274164
2024-11-20 06:41:26,1858332,46956,408,196776,18484,981768,378636,940164,322856,41604,55780,520908,355264,1261112,130552,560,1450072,20274504
2024-11-20 06:41:29,1858332,46820,408,196776,18484,982136,378636,940532,322856,41604,55780,520908,355264,1261392,130588,560,1450072,20274264
2024-11-20 06:41:32,1858332,47196,408,196776,18484,981868,378636,940264,322856,41604,55780,520908,355264,1261408,130544,560,1450072,20274212
2024-11-20 06:41:34,1858332,46788,408,196776,18484,982188,378636,940584,322856,41604,55780,520908,355264,1261640,130800,560,1450072,20274448
2024-11-20 06:41:37,1858332,44292,416,195264,18496,986456,376892,944632,322832,41824,54060,520908,355296,1265808,134632,560,1450072,22195872
2024-11-20 06:41:39,1858332,43268,420,196216,18140,989600,376908,947224,322328,42376,54580,520908,355640,1266052,133104,556,1450072,22195148
2024-11-20 06:41:42,1858332,56164,428,197500,18144,977888,377032,935280,321512,42608,55520,520908,355816,1255124,130080,556,1450072,20274340
2024-11-20 06:41:45,1858332,55712,428,197580,18140,978120,376996,935512,321392,42608,55604,520908,355820,1255392,130032,556,1450072,20274468
2024-11-20 06:41:47,1858332,54944,428,197680,18140,978852,377096,936244,321392,42608,55704,520908,355824,1256064,130132,556,1450072,20274204
2024-11-20 06:41:50,1858332,56748,428,197680,18140,977808,376840,935200,321136,42608,55704,520908,355824,1254740,129856,556,1450072,20274288
2024-11-20 06:41:52,1858332,56376,428,197680,18140,977632,376828,935024,321124,42608,55704,520908,355824,1254432,130288,556,1450072,20274380
2024-11-20 06:41:55,1858332,56112,428,197680,18140,978204,376836,935596,321132,42608,55704,520908,355832,1255152,130040,556,1450072,20274408
2024-11-20 06:41:57,1858332,55808,428,197680,18136,978440,376804,935832,321100,42608,55704,520908,355872,1255264,130148,556,1450072,20274256
2024-11-20 06:42:00,1858332,55608,428,197680,18136,978508,376804,935900,321100,42608,55704,520908,355872,1255436,130044,556,1450072,20274396
2024-11-20 06:42:02,1858332,55584,428,197680,18132,978712,376800,936104,321096,42608,55704,520908,355876,1255624,130312,556,1450072,20274288
2024-11-20 06:42:04,1858332,55508,428,197680,18132,978904,376800,936296,321096,42608,55704,520908,355876,1255892,130048,556,1450072,20274228
2024-11-20 06:42:07,1858332,55144,428,197680,18132,979280,376636,936672,320932,42608,55704,520908,355880,1255940,130252,556,1450072,20274360
2024-11-20 06:42:09,1858332,54860,428,197680,18132,979584,376636,936976,320932,42608,55704,520908,355880,1256208,130232,556,1450072,20274496
2024-11-20 06:42:12,1858332,54836,428,197680,18132,979640,376640,937032,320936,42608,55704,520908,355884,1256272,130072,556,1450072,20274276
2024-11-20 06:42:15,1858332,54280,428,197680,18132,979860,376640,937252,320936,42608,55704,520908,355884,1256672,130048,556,1450072,20274212
2024-11-20 06:42:17,1858332,54120,428,197680,18132,979892,376640,937284,320936,42608,55704,520908,355884,1256512,130116,556,1450072,20274300
2024-11-20 06:42:20,1858332,53708,428,197680,18136,980140,376648,937532,320944,42608,55704,520908,355888,1256736,130048,556,1450072,20274480
2024-11-20 06:42:22,1858332,53912,428,197680,18136,980060,376648,937452,320944,42608,55704,520908,355888,1256956,130048,556,1450072,20274392
2024-11-20 06:42:24,1858332,53520,428,197680,18136,980296,376648,937688,320944,42608,55704,520908,355888,1257200,130232,556,1450072,20274288
2024-11-20 06:42:27,1858332,53796,428,197680,18136,980276,376648,937668,320944,42608,55704,520908,355888,1257060,129864,556,1450072,20274408
2024-11-20 06:42:29,1858332,53228,428,197780,18136,980664,376748,938056,320944,42608,55804,520908,355888,1257516,130244,556,1450072,20274420
2024-11-20 06:42:32,1858332,53128,428,197780,18136,980860,376748,938252,320944,42608,55804,520908,355888,1257452,130244,556,1450072,20274348
2024-11-20 06:42:34,1858332,52760,428,197780,18136,981104,376752,938496,320948,42608,55804,520908,355892,1257948,130208,556,1450072,20274332
2024-11-20 06:42:37,1858332,53120,428,197780,18136,980984,376752,938376,320948,42608,55804,520908,355892,1257964,130060,556,1450072,20274288
2024-11-20 06:42:39,1858332,45628,428,197884,18136,988604,376856,945996,320948,42608,55908,520908,355892,1265324,130092,556,1450072,20274472
2024-11-20 06:42:41,1858332,45200,428,197884,18136,988588,376856,945980,320948,42608,55908,520908,355892,1265204,130068,556,1450072,20274416
2024-11-20 06:42:44,1858332,45020,428,197884,18136,988760,376856,946152,320948,42608,55908,520908,355892,1265396,130160,556,1450072,20274248
2024-11-20 06:42:47,1858332,44680,428,197884,18136,989124,376856,946516,320948,42608,55908,520908,355892,1265828,130068,556,1450072,20274312
2024-11-20 06:42:49,1858332,44520,428,197884,18136,989180,376856,946572,320948,42608,55908,520908,355920,1265832,130304,556,1450072,20274348
2024-11-20 06:42:52,1858332,46668,428,197884,18136,989548,374624,946940,318716,42608,55908,520908,355920,1264044,130068,556,1450072,20274428
2024-11-20 06:42:54,1858332,45928,428,197884,18136,989836,374576,947228,318668,42608,55908,520908,355920,1264352,130068,556,1450072,20274364
2024-11-20 06:42:57,1858332,45672,428,197884,18136,990496,374576,947888,318668,42608,55908,520908,355920,1264884,130128,556,1450072,20274368
2024-11-20 06:43:00,1858332,44536,428,197884,18132,991520,374580,948912,318672,42608,55908,520908,355928,1266116,130256,556,1450072,20274324
2024-11-20 06:43:02,1858332,50580,428,197884,18132,985476,374580,942868,318672,42608,55908,520908,355932,1259844,130220,556,1450072,20274432
2024-11-20 06:43:05,1858332,50624,428,197884,18132,985652,374580,943044,318672,42608,55908,520908,355932,1260080,130440,556,1450072,20274384
2024-11-20 06:43:07,1858332,50380,428,197884,18132,985944,374604,943336,318696,42608,55908,520908,355996,1260592,130256,556,1450072,20274480
2024-11-20 06:43:10,1858332,49464,428,197884,18132,986160,374604,943552,318696,42608,55908,520908,355996,1260576,130072,556,1450072,20274484
2024-11-20 06:43:12,1858332,49692,428,197952,18132,986388,374676,943780,318700,42608,55976,520908,356004,1260708,130076,556,1450072,20274428
2024-11-20 06:43:15,1858332,49396,428,197952,18132,986760,374684,944152,318708,42608,55976,520908,356008,1261220,130108,556,1450072,20274192
2024-11-20 06:43:17,1858332,49268,428,197952,18132,986636,374684,944028,318708,42608,55976,520908,356008,1261200,130260,556,1450072,20274208
2024-11-20 06:43:20,1858332,48596,428,197952,18132,986992,374684,944384,318708,42608,55976,520908,356008,1261400,130260,556,1450072,20274348
2024-11-20 06:43:22,1858332,48892,428,197952,18132,986992,374684,944384,318708,42608,55976,520908,356008,1261480,130080,556,1450072,20274268
2024-11-20 06:43:25,1858332,49060,428,197952,18132,987096,374684,944488,318708,42608,55976,520908,356008,1261484,130080,556,1450072,20274280
2024-11-20 06:43:28,1858332,48660,428,197952,18132,987236,374684,944628,318708,42608,55976,520908,356008,1261876,130264,556,1450072,20274184
2024-11-20 06:43:30,1858332,48104,428,197952,18132,987676,374684,945068,318708,42608,55976,520908,356008,1262108,130112,556,1450072,20274304
2024-11-20 06:43:32,1858332,48276,428,197952,18132,987652,374684,945044,318708,42608,55976,520908,356012,1261952,130080,556,1450072,20274312
2024-11-20 06:43:35,1858332,47908,428,197952,18132,987968,374688,945360,318712,42608,55976,520908,356012,1262376,130080,556,1450072,20274352
2024-11-20 06:43:37,1858332,47380,468,198772,18140,988048,375672,945440,318716,42608,56956,520908,358408,1262544,130264,556,1450072,20270880
2024-11-20 06:43:40,1858332,44224,468,199488,18132,990760,376224,948088,318744,42672,57480,520908,358424,1265136,130800,564,1450072,20274392
2024-11-20 06:43:42,1858332,43920,468,199488,18132,990836,376224,948164,318744,42672,57480,520908,358424,1265164,130776,564,1450072,20274384
2024-11-20 06:43:45,1858332,39220,468,202296,18132,993164,378952,950492,318664,42672,60288,520908,358424,1267452,131160,564,1450072,20275816
2024-11-20 06:43:48,1858332,38332,468,202296,18132,993420,378956,950748,318668,42672,60288,520908,358428,1267748,131112,564,1450072,20276016
2024-11-20 06:43:50,1858332,38428,468,202296,18132,993508,378956,950836,318668,42672,60288,520908,358428,1267852,131172,564,1450072,20276004
2024-11-20 06:43:53,1858332,38352,468,202296,18132,993444,378956,950772,318668,42672,60288,520908,358428,1267836,131112,564,1450072,20275948
2024-11-20 06:43:55,1858332,38392,468,202296,18132,993680,378956,951008,318668,42672,60288,520908,358432,1268104,130976,564,1450072,20275964
2024-11-20 06:43:58,1858332,38324,468,202296,18132,993752,378960,951080,318672,42672,60288,520908,358432,1268008,130928,564,1450072,20276104
2024-11-20 06:44:00,1858332,37924,468,202296,18132,994276,378960,951604,318672,42672,60288,520908,358432,1268748,131100,564,1450072,20275904
2024-11-20 06:44:02,1858332,37864,468,202296,18132,994224,378964,951552,318676,42672,60288,520908,358436,1268624,131112,564,1450072,20275900
2024-11-20 06:44:05,1858332,37536,468,202296,18132,994616,378972,951944,318684,42672,60288,520908,358444,1268908,131084,564,1450072,20275832
2024-11-20 06:44:07,1858332,37168,468,202296,18132,994452,378964,951780,318676,42672,60288,520908,358492,1268820,130972,564,1450072,20275936
2024-11-20 06:44:10,1858332,36892,468,202296,18132,994972,378964,952300,318676,42672,60288,520908,358492,1269308,131180,564,1450072,20275892
2024-11-20 06:44:13,1858332,36776,468,202296,18132,994996,378964,952324,318676,42672,60288,520908,358492,1269460,130972,564,1450072,20275820
2024-11-20 06:44:15,1858332,36520,468,202296,18132,995592,378964,952920,318676,42672,60288,520908,358492,1269896,131200,564,1450072,20275896
2024-11-20 06:44:18,1858332,36444,468,202296,18132,995720,378964,953048,318676,42672,60288,520908,358492,1270076,131156,564,1450072,20275848
2024-11-20 06:44:20,1858332,36416,468,201560,18132,996108,377828,953436,318540,42672,59288,520908,358492,1270496,131156,564,1450072,20267792
2024-11-20 06:44:23,1858332,38044,468,200600,18132,996252,377044,953492,318540,42760,58504,520908,358492,1270392,131156,564,1450072,20275836
2024-11-20 06:44:25,1858332,37808,468,200600,18132,996556,377044,953796,318540,42760,58504,520908,358492,1270700,131208,564,1450072,20275936
2024-11-20 06:44:28,1858332,37188,468,200600,18132,997024,377044,954264,318540,42760,58504,520908,358492,1271208,130972,564,1450072,20275804
2024-11-20 06:44:30,1858332,40668,468,200600,18132,992992,377044,950232,318540,42760,58504,520908,358492,1266776,131212,564,1450072,20275888
2024-11-20 06:44:33,1858332,43748,468,200600,18132,990264,377048,947504,318544,42760,58504,520908,358516,1264388,131100,564,1450072,20275796
2024-11-20 06:44:36,1858332,44028,468,200600,18132,990468,377048,947708,318544,42760,58504,520908,358516,1264332,130976,564,1450072,20275748
2024-11-20 06:44:38,1858332,43808,468,200600,18132,990480,377048,947720,318544,42760,58504,520908,358516,1264668,131200,564,1450072,20275888
2024-11-20 06:44:41,1858332,43868,468,200600,18132,990532,377048,947772,318544,42760,58504,520908,358516,1264680,131160,564,1450072,20267772
2024-11-20 06:44:43,1858332,43336,468,200600,18132,991048,377048,948288,318544,42760,58504,520908,358516,1265192,131176,564,1450072,20275908
2024-11-20 06:44:46,1858332,43232,468,200600,18132,991012,377052,948252,318548,42760,58504,520908,358524,1265320,131160,564,1450072,20275940
2024-11-20 06:44:48,1858332,43176,468,200600,18132,991124,377056,948364,318552,42760,58504,520908,358524,1265392,131160,564,1450072,20275768
2024-11-20 06:44:51,1858332,42852,468,200600,18132,991536,377056,948776,318552,42760,58504,520908,358524,1265664,131184,564,1450072,20275944
2024-11-20 06:44:54,1858332,43152,468,200600,18132,991504,377056,948744,318552,42760,58504,520908,358524,1265852,131160,564,1450072,20275940
2024-11-20 06:44:56,N/A,N/A,N/A,N/A,N/A,N/A,N/A,N/A,N/A,N/A,N/A,N/A,N/A,N/A,N/A,N/A,N/A,N/A
2024-11-20 06:44:59,1858332,38980,676,201424,18064,995768,377324,952580,318416,43188,58908,520908,358588,1269544,134912,564,1450072,22196612
2024-11-20 06:45:01,1858332,38112,676,202492,18064,995928,378460,952708,318428,43220,60032,520908,358588,1269664,135212,564,1450072,22196456
2024-11-20 06:45:04,1858332,38012,684,202464,18064,996012,378544,952792,318428,43220,60116,520908,358588,1269836,135204,564,1450072,22196468
2024-11-20 06:45:06,1858332,37900,684,202464,18064,996352,378552,953132,318428,43220,60124,520908,358588,1270100,135144,564,1450072,22196452
2024-11-20 06:45:09,1858332,37588,684,202464,18064,996420,378552,953200,318428,43220,60124,520908,358588,1270324,135020,564,1450072,22196384
2024-11-20 06:45:11,1858332,37524,684,202464,18064,996380,378552,953160,318428,43220,60124,520908,358588,1270260,135040,564,1450072,22196548
2024-11-20 06:45:14,1858332,39512,684,201016,18040,996416,376796,953072,318240,43344,58556,520908,358456,1267412,131340,564,1450072,22196364
2024-11-20 06:45:16,1858332,42684,684,200988,18064,994096,376640,950600,318268,43496,58372,520908,358484,1267384,131188,564,1450072,20276068
2024-11-20 06:45:19,N/A,N/A,N/A,N/A,N/A,N/A,N/A,N/A,N/A,N/A,N/A,N/A,N/A,N/A,N/A,N/A,N/A,N/A
2024-11-20 06:45:22,1858332,36940,684,202628,18212,998256,377932,954436,318260,43820,59672,520908,358500,1271200,135140,564,1450072,22196624
2024-11-20 06:45:24,1858332,36668,684,202644,18244,998652,377972,954828,318272,43824,59700,520908,358500,1271608,135268,564,1450072,22196404
2024-11-20 06:45:27,1858332,36276,692,202644,18252,998568,377976,954744,318276,43824,59700,520908,358500,1271464,135068,564,1450072,22196552
2024-11-20 06:45:29,1858332,38188,692,200996,18252,999328,375644,954760,318292,44568,57352,520908,358300,1268852,131204,564,1450072,22196628
2024-11-20 06:45:32,1858332,45924,692,200976,18252,992304,375456,947672,318224,44632,57232,520908,358320,1264232,130992,564,1450072,20276052
2024-11-20 06:45:35,1858332,45276,692,200976,18252,992976,375456,948344,318224,44632,57232,520908,358320,1265028,131236,564,1450072,20276060
2024-11-20 06:45:37,1858332,43508,732,201596,18268,994208,376200,949564,318320,44644,57880,520908,358400,1266164,131320,564,1450072,20276012
2024-11-20 06:45:40,1858332,43232,732,201596,18264,994388,376204,949744,318324,44644,57880,520908,358428,1266756,131292,564,1450072,20275884
2024-11-20 06:45:42,1858332,42972,740,201596,18264,994896,376100,950252,318212,44644,57888,520908,358428,1266820,131300,564,1450072,20275832
2024-11-20 06:45:45,1858332,42740,740,201596,18264,995192,376012,950548,318124,44644,57888,520908,358460,1267132,131316,564,1450072,20275752
2024-11-20 06:45:47,1858332,42876,740,201596,18264,995508,376012,950864,318124,44644,57888,520908,358460,1267384,131292,564,1450072,20276032
2024-11-20 06:45:50,1858332,42880,740,201596,18264,995620,376012,950976,318124,44644,57888,520908,358460,1267688,131236,564,1450072,20275944
2024-11-20 06:45:52,1858332,42876,740,201596,18264,995544,376012,950900,318124,44644,57888,520908,358460,1267544,131292,564,1450072,20275876
2024-11-20 06:45:55,1858332,41656,740,201596,18264,996312,376012,951668,318124,44644,57888,520908,358468,1268288,131292,564,1450072,22195432
2024-11-20 06:45:58,1858332,36020,740,199124,18244,1002496,373776,957460,318888,45036,54888,520908,358188,1275184,136592,564,1450072,24117176
2024-11-20 06:46:00,1858332,33776,688,193412,18176,1010700,368764,964380,320844,46320,47920,520908,358092,1284032,141440,568,1450072,24118564
2024-11-20 06:46:03,1858332,45916,784,190792,18180,1000760,367336,954772,321556,45988,45780,520908,357224,1274920,138768,564,1450072,22197064
2024-11-20 06:46:06,1858332,45416,784,190796,18180,1000864,367328,954856,321560,46008,45768,520908,357228,1275020,138760,560,1450072,22197020
2024-11-20 06:46:08,1858332,45680,792,190796,18180,1000860,367336,954852,321564,46008,45772,520908,357232,1275056,138764,560,1450072,22196948
2024-11-20 06:46:10,1858332,45512,792,190796,18180,1000896,367336,954888,321564,46008,45772,520908,357232,1275104,138764,560,1450072,22196820
2024-11-20 06:46:13,1858332,45872,792,190796,18180,1000720,367344,954712,321564,46008,45780,520908,357232,1275180,138684,560,1450072,22197008
2024-11-20 06:46:15,1858332,45904,792,190796,18180,1001012,367344,955004,321564,46008,45780,520908,357232,1275172,138764,560,1450072,22197016
2024-11-20 06:46:18,1858332,45168,792,190796,18180,1001396,367344,955388,321564,46008,45780,520908,357232,1275424,138784,560,1450072,22196984
2024-11-20 06:46:21,1858332,45284,792,190796,18180,1001608,367344,955600,321564,46008,45780,520908,357232,1275648,138764,560,1450072,22197052
2024-11-20 06:46:23,1858332,44720,792,190796,18180,1001932,367344,955924,321564,46008,45780,520908,357232,1276268,138784,560,1450072,22196912
2024-11-20 06:46:26,1858332,47372,792,190796,18180,998976,367344,952968,321564,46008,45780,520908,357232,1272848,138764,560,1450072,22197048
2024-11-20 06:46:28,1858332,51000,792,190808,18232,996244,367428,950236,321648,46008,45780,520908,357272,1270356,138032,560,1450072,22188940
2024-11-20 06:46:31,1858332,50764,792,190796,18232,996012,367436,950004,321656,46008,45780,520908,357272,1270292,138012,560,1450072,22196944
2024-11-20 06:46:33,1858332,50400,792,190796,18232,996536,367436,950528,321656,46008,45780,520908,357272,1270844,138012,560,1450072,22197088
2024-11-20 06:46:35,1858332,49884,792,191192,18232,996624,367768,950616,321652,46008,46116,520908,357272,1271016,137860,560,1450072,22196940
2024-11-20 06:46:38,1858332,49316,792,191192,18232,996972,367828,950964,321652,46008,46176,520908,357272,1271220,138064,560,1450072,22197084
2024-11-20 06:46:41,1858332,49144,792,191192,18236,997004,367836,950996,321660,46008,46176,520908,357276,1271160,137860,560,1450072,22197140
2024-11-20 06:46:43,1858332,49160,792,191192,18236,997316,367836,951308,321660,46008,46176,520908,357276,1271468,138064,560,1450072,22197020
2024-11-20 06:46:45,1858332,49044,792,191192,18236,997544,367836,951536,321660,46008,46176,520908,357276,1271896,138044,560,1450072,22196960
2024-11-20 06:46:48,1858332,48420,792,191192,18236,997836,367836,951828,321660,46008,46176,520908,357276,1272072,137984,560,1450072,22197056
2024-11-20 06:46:51,1858332,48480,792,191192,18236,997936,367836,951928,321660,46008,46176,520908,357276,1272332,138044,560,1450072,22197140
2024-11-20 06:46:53,1858332,48308,792,191192,18236,998040,367836,952032,321660,46008,46176,520908,357276,1272380,138008,560,1450072,22197072
2024-11-20 06:46:56,1858332,47828,792,191192,18236,998128,367836,952120,321660,46008,46176,520908,357276,1272636,137860,560,1450072,22196948
2024-11-20 06:46:59,1858332,47824,792,191192,18236,998384,367836,952376,321660,46008,46176,520908,357276,1272824,138044,560,1450072,22196964
2024-11-20 06:47:01,1858332,47756,792,191192,18236,998688,367836,952680,321660,46008,46176,520908,357276,1272844,137904,560,1450072,22196744
2024-11-20 06:47:04,1858332,47560,792,191192,18232,998896,367844,952888,321668,46008,46176,520908,357288,1273124,138068,560,1450072,22196852
2024-11-20 06:47:07,1858332,46872,792,191192,18232,999200,367844,953192,321668,46008,46176,520908,357288,1273276,138048,560,1450072,22196856
2024-11-20 06:47:09,1858332,47224,792,191192,18232,999340,367848,953332,321672,46008,46176,520908,357292,1273444,138068,560,1450072,22196936
2024-11-20 06:47:12,1858332,46724,792,191192,18232,999556,367848,953548,321672,46008,46176,520908,357292,1273728,138092,560,1450072,22196860
2024-11-20 06:47:15,1858332,46756,792,191192,18232,999224,367848,953216,321672,46008,46176,520908,357292,1273600,138048,560,1450072,22196848
2024-11-20 06:47:17,1858332,46604,792,191192,18232,999584,367848,953576,321672,46008,46176,520908,357292,1273968,138068,560,1450072,22196776
2024-11-20 06:47:20,1858332,46576,792,191192,18232,999956,367848,953948,321672,46008,46176,520908,357292,1274268,138048,560,1450072,22196668
2024-11-20 06:47:22,1858332,46352,792,191192,18232,1000260,367848,954252,321672,46008,46176,520908,357292,1274500,137968,560,1450072,22196852
2024-11-20 06:47:24,1858332,45504,792,191192,18232,1000652,367852,954644,321676,46008,46176,520908,357296,1274704,138048,560,1450072,22196900
2024-11-20 06:47:27,1858332,45456,792,191192,18232,1000896,367852,954888,321676,46008,46176,520908,357296,1275092,137996,560,1450072,22196828
2024-11-20 06:47:30,1858332,45216,792,191192,18232,1000812,367852,954804,321676,46008,46176,520908,357296,1274944,138232,560,1450072,22196828
2024-11-20 06:47:32,1858332,44996,792,191192,18232,1001212,367856,955204,321680,46008,46176,520908,357300,1275572,138068,560,1450072,22196832
2024-11-20 06:47:35,1858332,44804,792,191192,18232,1001464,367856,955456,321680,46008,46176,520908,357300,1275716,138048,560,1450072,22196740
2024-11-20 06:47:37,1858332,45044,792,191192,18232,1001504,367856,955496,321680,46008,46176,520908,357300,1275852,138084,560,1450072,22196944
2024-11-20 06:47:40,1858332,44116,792,191192,18228,1002204,367856,956196,321680,46008,46176,520908,357304,1276780,138048,560,1450072,22196832
2024-11-20 06:47:42,1858332,49872,792,191192,18228,996708,367856,950700,321680,46008,46176,520908,357304,1271232,138048,560,1450072,22188556
2024-11-20 06:47:45,1858332,49292,792,191192,18228,997192,367856,951184,321680,46008,46176,520908,357304,1271476,137864,560,1450072,22196740
2024-11-20 06:47:47,1858332,49572,792,191192,18228,997564,367860,951556,321684,46008,46176,520908,357308,1271884,137988,560,1450072,22196900
2024-11-20 06:47:50,1858332,48784,792,191192,18228,998244,367860,952236,321684,46008,46176,520908,357308,1272416,138048,560,1450072,22196796
2024-11-20 06:47:53,1858332,48540,792,191192,18228,998416,367860,952408,321684,46008,46176,520908,357308,1272660,138048,560,1450072,22196888
2024-11-20 06:47:55,1858332,48280,792,191192,18228,998672,367860,952664,321684,46008,46176,520908,357308,1273020,138004,560,1450072,22196896
2024-11-20 06:47:58,1858332,47976,792,191192,18228,999016,367860,953008,321684,46008,46176,520908,357308,1273156,138048,560,1450072,22196824
2024-11-20 06:48:00,1858332,47924,792,191192,18228,999120,367860,953112,321684,46008,46176,520908,357308,1273428,138100,560,1450072,22196740
2024-11-20 06:48:03,1858332,47800,792,191192,18228,999356,367860,953348,321684,46008,46176,520908,357308,1273740,138048,560,1450072,22196676
2024-11-20 06:48:05,1858332,47268,792,191192,18228,999616,367860,953608,321684,46008,46176,520908,357308,1274084,138048,560,1450072,22196852
2024-11-20 06:48:08,1858332,47340,792,191192,18228,999792,367864,953784,321688,46008,46176,520908,357312,1274148,138068,560,1450072,22196700
2024-11-20 06:48:11,1858332,47484,792,191192,18228,999800,367864,953792,321688,46008,46176,520908,357312,1273972,138048,560,1450072,22196808
2024-11-20 06:48:13,1858332,47084,792,191192,18228,1000236,367864,954228,321688,46008,46176,520908,357316,1274688,138112,560,1450072,22196764
2024-11-20 06:48:16,1858332,46816,792,191192,18228,1000696,367868,954688,321692,46008,46176,520908,357316,1275196,138048,560,1450072,22196752
2024-11-20 06:48:18,1858332,45568,792,191192,18228,1001656,367868,955648,321692,46008,46176,520908,357320,1275992,138088,560,1450072,22196740
2024-11-20 06:48:21,1858332,45120,792,191192,18228,1001920,367872,955912,321696,46008,46176,520908,357320,1276284,137988,560,1450072,22196800
2024-11-20 06:48:24,1858332,44932,792,191192,18228,1001880,367872,955872,321696,46008,46176,520908,357320,1276152,138048,560,1450072,22196820
2024-11-20 06:48:26,1858332,44656,792,191192,18228,1002180,367872,956172,321696,46008,46176,520908,357320,1276332,138076,560,1450072,22196992
2024-11-20 06:48:29,1858332,44916,792,191192,18228,1002268,367872,956260,321696,46008,46176,520908,357320,1276560,138056,560,1450072,22196680
2024-11-20 06:48:31,1858332,44336,792,191192,18228,1002616,367872,956608,321696,46008,46176,520908,357320,1277092,137864,560,1450072,22196884
2024-11-20 06:48:34,1858332,43968,792,191192,18228,1002680,367872,956672,321696,46008,46176,520908,357320,1276876,138048,560,1450072,22196888
2024-11-20 06:48:36,1858332,44276,792,191192,18228,1002928,367872,956920,321696,46008,46176,520908,357320,1277340,138048,560,1450072,22196872
2024-11-20 06:48:39,1858332,43900,792,191192,18228,1003080,367872,957072,321696,46008,46176,520908,357320,1277176,138008,560,1450072,22196728
2024-11-20 06:48:42,1858332,43640,792,191192,18228,1002944,367872,956936,321696,46008,46176,520908,357320,1277228,138048,560,1450072,22196764
2024-11-20 06:48:44,1858332,43644,792,191192,18228,1003164,367872,957156,321696,46008,46176,520908,357320,1277756,138104,560,1450072,22196820
2024-11-20 06:48:47,1858332,40900,792,193036,18228,1004056,369716,958048,321696,46008,48020,520908,357320,1278388,137872,560,1450072,22196808
2024-11-20 06:48:49,1858332,48892,792,193036,18228,995900,369716,949892,321696,46008,48020,520908,357320,1270272,138100,560,1450072,22196932
2024-11-20 06:48:52,1858332,48748,792,193036,18228,996304,369716,950296,321696,46008,48020,520908,357320,1270728,138076,560,1450072,22196816
2024-11-20 06:48:54,1858332,48520,792,193036,18228,995992,369716,949984,321696,46008,48020,520908,357320,1270572,138056,560,1450072,22196700
2024-11-20 06:48:57,1858332,48400,828,193044,18228,996704,369772,950680,321724,46024,48048,520908,357364,1270968,138104,560,1450072,22196764
2024-11-20 06:49:00,1858332,48292,828,193044,18228,996612,369772,950588,321724,46024,48048,520908,357368,1270900,138060,560,1450072,22196756
2024-11-20 06:49:02,1858332,47968,836,193044,18228,997004,369776,950980,321728,46024,48048,520908,357368,1271204,138060,560,1450072,22196848
2024-11-20 06:49:05,1858332,47888,836,193044,18228,997144,369784,951120,321728,46024,48056,520908,357368,1271528,138112,560,1450072,22196980
2024-11-20 06:49:08,1858332,47504,836,193044,18228,997628,369788,951604,321732,46024,48056,520908,357372,1271964,138008,560,1450072,22196840
2024-11-20 06:49:11,1858332,47024,836,193044,18228,997844,369788,951820,321732,46024,48056,520908,357372,1271952,138060,560,1450072,22196820
2024-11-20 06:49:13,1858332,46996,836,193044,18228,997928,369788,951904,321732,46024,48056,520908,357372,1272036,138080,560,1450072,22196992
2024-11-20 06:49:16,1858332,47140,836,193044,18228,997636,369788,951612,321732,46024,48056,520908,357372,1272236,138060,560,1450072,22196788
2024-11-20 06:49:18,1858332,47000,836,193044,18228,998040,369788,952016,321732,46024,48056,520908,357372,1272320,138112,560,1450072,22196872
2024-11-20 06:49:21,1858332,46692,836,193044,18228,998428,369788,952404,321732,46024,48056,520908,357372,1272744,138080,560,1450072,22196752
2024-11-20 06:49:24,1858332,46084,836,193044,18228,998556,369788,952532,321732,46024,48056,520908,357372,1272752,137876,560,1450072,22196840
2024-11-20 06:49:26,1858332,45920,836,193044,18228,998876,369788,952852,321732,46024,48056,520908,357372,1273232,138060,560,1450072,22196908
2024-11-20 06:49:29,1858332,45972,836,193044,18228,998796,369788,952772,321732,46024,48056,520908,357372,1273156,138060,560,1450072,22196880
2024-11-20 06:49:31,1858332,45568,836,193044,18228,999096,369788,953072,321732,46024,48056,520908,357372,1273476,137876,560,1450072,22196748
2024-11-20 06:49:34,1858332,45552,836,193044,18228,999220,369788,953196,321732,46024,48056,520908,357372,1273532,138060,560,1450072,22196760
2024-11-20 06:49:36,1858332,45268,836,193044,18228,999580,369788,953556,321732,46024,48056,520908,357372,1273948,138060,560,1450072,22196752
2024-11-20 06:49:39,1858332,45284,836,193044,18228,999824,369788,953800,321732,46024,48056,520908,357372,1274260,137876,560,1450072,22196716
2024-11-20 06:49:41,1858332,45128,836,193044,18228,999988,369788,953964,321732,46024,48056,520908,357372,1274324,138112,560,1450072,22196860
2024-11-20 06:49:44,1858332,44700,836,193256,18228,1000268,369956,954244,321732,46024,48224,520908,357372,1274468,138080,560,1450072,22196984
2024-11-20 06:49:47,1858332,44572,836,193256,18228,1000068,370000,954044,321732,46024,48268,520908,357372,1274544,138080,560,1450072,22196928
2024-11-20 06:49:49,1858332,44308,836,193256,18228,1000504,370000,954480,321732,46024,48268,520908,357372,1274788,138100,560,1450072,22196760
2024-11-20 06:49:51,1858332,44548,836,193256,18228,1000460,370000,954436,321732,46024,48268,520908,357372,1274628,138080,560,1450072,22196892
2024-11-20 06:49:54,1858332,43976,836,193256,18228,1000888,370004,954864,321736,46024,48268,520908,357376,1275160,138088,560,1450072,22196880
2024-11-20 06:49:57,1858332,43288,836,193256,18228,1001160,370012,955136,321744,46024,48268,520908,357384,1275428,137896,560,1450072,22196800
2024-11-20 06:49:59,1858332,43384,836,193256,18228,1001308,370012,955284,321744,46024,48268,520908,357384,1275880,137896,560,1450072,22196880
2024-11-20 06:50:02,1858332,43116,836,193256,18228,1001456,370012,955432,321744,46024,48268,520908,357384,1275696,138080,560,1450072,22196924
2024-11-20 06:50:05,1858332,42804,836,193256,18228,1001532,370012,955508,321744,46024,48268,520908,357384,1275952,137896,560,1450072,22196916
2024-11-20 06:50:07,1858332,42916,836,193256,18228,1001576,370012,955552,321744,46024,48268,520908,357384,1275700,138100,560,1450072,22196736
2024-11-20 06:50:10,1858332,42592,836,193256,18228,1001812,370012,955788,321744,46024,48268,520908,357384,1276040,137896,560,1450072,22196868
2024-11-20 06:50:12,1858332,42012,836,193256,18228,1002316,370012,956292,321744,46024,48268,520908,357384,1276716,138132,560,1450072,22196828
2024-11-20 06:50:15,1858332,47828,836,193256,18228,996656,370012,950632,321744,46024,48268,520908,357384,1270960,137996,560,1450072,22196752
2024-11-20 06:50:17,1858332,47476,836,193256,18228,996816,370012,950792,321744,46024,48268,520908,357384,1271120,137896,560,1450072,22196748
2024-11-20 06:50:20,1858332,47364,836,193256,18228,997140,370012,951116,321744,46024,48268,520908,357384,1271320,138048,560,1450072,22196760
2024-11-20 06:50:23,1858332,47248,836,193256,18228,997380,370012,951356,321744,46024,48268,520908,357384,1271644,138080,560,1450072,22196776
2024-11-20 06:50:25,1858332,46952,836,193256,18228,997880,370012,951856,321744,46024,48268,520908,357384,1272172,138064,560,1450072,22196860
2024-11-20 06:50:28,1858332,46584,836,193256,18228,997864,370012,951840,321744,46024,48268,520908,357384,1272044,138080,560,1450072,22196776
2024-11-20 06:50:30,1858332,46752,836,193256,18228,997868,370016,951844,321748,46024,48268,520908,357388,1272188,138100,560,1450072,22196696
2024-11-20 06:50:33,1858332,46240,836,193256,18228,998724,370016,952700,321748,46024,48268,520908,357388,1273036,137896,560,1450072,22196756
2024-11-20 06:50:35,1858332,45924,836,193256,18224,998860,370064,952836,321796,46024,48268,520908,357440,1273408,138084,560,1450072,22196880
2024-11-20 06:50:37,1858332,45868,836,193256,18224,999252,370064,953228,321796,46024,48268,520908,357440,1273756,138132,560,1450072,22196756
2024-11-20 06:50:40,1858332,45388,836,193256,18224,999312,370064,953288,321796,46024,48268,520908,357440,1273544,137716,560,1450072,22196752
2024-11-20 06:50:42,1858332,45292,836,193256,18224,999420,370064,953396,321796,46024,48268,520908,357440,1274084,137952,560,1450072,22196768
2024-11-20 06:50:45,1858332,45204,836,193256,18224,999456,370064,953432,321796,46024,48268,520908,357440,1274000,137900,560,1450072,22196884
2024-11-20 06:50:47,1858332,44716,836,193256,18224,999892,370064,953868,321796,46024,48268,520908,357440,1274392,138120,560,1450072,22196892
2024-11-20 06:50:50,1858332,44496,836,193256,18224,999976,370064,953952,321796,46024,48268,520908,357440,1274576,138084,560,1450072,22196832
2024-11-20 06:50:53,1858332,44152,836,193256,18224,1000216,370064,954192,321796,46024,48268,520908,357440,1274676,137900,560,1450072,22196764
2024-11-20 06:50:55,1858332,43492,836,193256,18224,1001084,370068,955060,321800,46024,48268,520908,357444,1275472,138104,560,1450072,22196748
2024-11-20 06:50:58,1858332,43344,836,193256,18224,1001104,370068,955080,321800,46024,48268,520908,357444,1275408,138084,560,1450072,22196876
2024-11-20 06:51:00,1858332,42692,836,193256,18224,1002200,370068,956176,321800,46024,48268,520908,357444,1276408,138104,560,1450072,22196844
2024-11-20 06:51:03,1858332,42516,836,193256,18224,1002228,370068,956204,321800,46024,48268,520908,357444,1276640,138084,560,1450072,22196740
2024-11-20 06:51:05,1858332,42324,836,193256,18224,1002712,370068,956688,321800,46024,48268,520908,357444,1277064,137920,560,1450072,22196868
2024-11-20 06:51:08,1858332,48120,836,193256,18224,995952,370072,949928,321804,46024,48268,520908,357460,1270244,138084,560,1450072,22196868
2024-11-20 06:51:10,1858332,48724,836,193256,18224,995916,370080,949892,321812,46024,48268,520908,357460,1270224,138084,560,1450072,22196860
2024-11-20 06:51:13,1858332,47972,836,193256,18224,996292,370080,950268,321812,46024,48268,520908,357460,1270504,137900,560,1450072,22196844
2024-11-20 06:51:16,1858332,47620,836,193256,18224,996592,370080,950568,321812,46024,48268,520908,357460,1270844,138084,560,1450072,22196768
2024-11-20 06:51:18,1858332,47636,836,193256,18224,996972,370084,950948,321816,46024,48268,520908,357464,1271352,138088,560,1450072,22196968
2024-11-20 06:51:21,1858332,47452,836,193256,18224,997180,370084,951156,321816,46024,48268,520908,357464,1271460,138084,560,1450072,22196800
2024-11-20 06:51:23,1858332,47000,836,193256,18224,997412,370084,951388,321816,46024,48268,520908,357464,1271768,138136,560,1450072,22196828
2024-11-20 06:51:26,1858332,46760,836,193256,18224,997780,370084,951756,321816,46024,48268,520908,357464,1272268,138024,560,1450072,22196968
2024-11-20 06:51:29,1858332,46756,836,193256,18224,998016,370084,951992,321816,46024,48268,520908,357464,1272524,138268,560,1450072,22196720
2024-11-20 06:51:31,1858332,46136,836,193256,18224,998736,370084,952712,321816,46024,48268,520908,357464,1273076,137920,560,1450072,22196736
2024-11-20 06:51:34,1858332,45668,836,193256,18224,999256,370084,953232,321816,46024,48268,520908,357464,1273540,138084,560,1450072,22196784
2024-11-20 06:51:36,1858332,45460,836,193256,18224,999528,370084,953504,321816,46024,48268,520908,357464,1273904,138136,560,1450072,22196636
2024-11-20 06:51:39,1858332,45324,836,193256,18224,999388,370084,953364,321816,46024,48268,520908,357464,1273792,138084,560,1450072,22196704
2024-11-20 06:51:41,1858332,45188,836,193256,18224,999544,370084,953520,321816,46024,48268,520908,357464,1273856,138084,560,1450072,22196772
2024-11-20 06:51:44,1858332,44736,836,193256,18224,999776,370084,953752,321816,46024,48268,520908,357464,1274292,138104,560,1450072,22196700
2024-11-20 06:51:47,1858332,44972,836,193256,18224,999928,370084,953904,321816,46024,48268,520908,357464,1274512,137900,560,1450072,22196980
2024-11-20 06:51:49,1858332,44524,836,193256,18224,1000064,370084,954040,321816,46024,48268,520908,357464,1274580,138136,560,1450072,22196804
2024-11-20 06:51:52,1858332,44400,836,193256,18224,1000556,370084,954532,321816,46024,48268,520908,357464,1275000,138076,560,1450072,22196768
2024-11-20 06:51:54,1858332,44160,836,193256,18224,1000500,370084,954476,321816,46024,48268,520908,357464,1274796,138084,560,1450072,22196876
2024-11-20 06:51:57,1858332,44008,836,193256,18224,1000936,370088,954912,321820,46024,48268,520908,357468,1275344,138084,560,1450072,22196792
2024-11-20 06:51:59,1858332,43848,836,193256,18224,1000916,370088,954892,321820,46024,48268,520908,357468,1275152,138108,560,1450072,22196772
2024-11-20 06:52:02,1858332,43540,836,193256,18224,1001328,370088,955304,321820,46024,48268,520908,357468,1275716,138108,560,1450072,22196776
2024-11-20 06:52:05,1858332,43224,836,193256,18224,1001228,370088,955204,321820,46024,48268,520908,357468,1275536,138088,560,1450072,22196756
2024-11-20 06:52:07,1858332,43036,836,193256,18224,1001732,370088,955708,321820,46024,48268,520908,357468,1276172,137996,560,1450072,22196956
2024-11-20 06:52:10,1858332,42852,836,193256,18224,1001604,370088,955580,321820,46024,48268,520908,357468,1276028,138088,560,1450072,22196824
2024-11-20 06:52:12,1858332,42664,836,193256,18224,1002036,370088,956012,321820,46024,48268,520908,357468,1276320,137904,560,1450072,22196696
2024-11-20 06:52:15,1858332,42580,836,193256,18224,1002120,370088,956096,321820,46024,48268,520908,357468,1276448,138028,560,1450072,22196980
2024-11-20 06:52:18,1858332,42076,836,193256,18224,1002368,370088,956344,321820,46024,48268,520908,357468,1276772,138088,560,1450072,22196876
2024-11-20 06:52:20,1858332,48248,836,193256,18224,996320,370088,950296,321820,46024,48268,520908,357468,1270692,138060,560,1450072,22196832
2024-11-20 06:52:23,1858332,48096,836,193256,18224,996196,370088,950172,321820,46024,48268,520908,357468,1270760,137904,560,1450072,22196668
2024-11-20 06:52:25,1858332,47956,836,193256,18224,996540,370088,950516,321820,46024,48268,520908,357468,1270936,138108,560,1450072,22196804
2024-11-20 06:52:28,1858332,47812,836,193256,18224,996696,370088,950672,321820,46024,48268,520908,357468,1271004,138088,560,1450072,22196704
2024-11-20 06:52:30,1858332,47592,836,193256,18224,996920,370088,950896,321820,46024,48268,520908,357468,1271512,138132,560,1450072,22196872
2024-11-20 06:52:33,1858332,47332,836,193256,18224,997512,370088,951488,321820,46024,48268,520908,357468,1272008,138108,560,1450072,22196708
2024-11-20 06:52:36,1858332,46864,836,193256,18224,997880,370088,951856,321820,46024,48268,520908,357468,1272512,138088,560,1450072,22196888
2024-11-20 06:52:38,1858332,45812,836,193256,18224,998332,370088,952308,321820,46024,48268,520908,357468,1272716,138108,560,1450072,22196920
2024-11-20 06:52:41,1858332,45988,836,193256,18224,998348,370088,952324,321820,46024,48268,520908,357468,1272840,137904,560,1450072,22196912
2024-11-20 06:52:43,1858332,45348,836,193256,18224,998756,370088,952732,321820,46024,48268,520908,357468,1273108,138212,560,1450072,22196872
2024-11-20 06:52:45,1858332,45124,836,193256,18224,999152,370088,953128,321820,46024,48268,520908,357468,1273488,138088,560,1450072,22196864
2024-11-20 06:52:48,1858332,44376,836,193256,18224,999772,370088,953748,321820,46024,48268,520908,357468,1274156,138108,560,1450072,22196940
2024-11-20 06:52:50,1858332,44344,836,193432,18224,1000456,370008,954180,321816,46276,48192,520908,357468,1274732,137904,560,1450072,22196840
2024-11-20 06:52:53,1858332,44028,836,193432,18224,1000940,370008,954664,321816,46276,48192,520908,357468,1274940,138088,560,1450072,22196816
2024-11-20 06:52:56,1858332,43388,836,193432,18224,1001508,370008,955232,321816,46276,48192,520908,357468,1275832,137904,560,1450072,22196988
2024-11-20 06:52:58,1858332,42768,836,193432,18224,1001820,370008,955544,321816,46276,48192,520908,357468,1275944,138140,560,1450072,22196880
2024-11-20 06:53:01,1858332,42764,836,193432,18224,1002124,370008,955848,321816,46276,48192,520908,357468,1276328,138088,560,1450072,22196780
2024-11-20 06:53:03,1858332,42132,836,193432,18224,1002292,370008,956016,321816,46276,48192,520908,357468,1276636,138088,560,1450072,22196708
2024-11-20 06:53:06,1858332,42268,836,193432,18224,1002464,370008,956188,321816,46276,48192,520908,357468,1276648,138108,560,1450072,22196872
2024-11-20 06:53:09,1858332,47932,836,193432,18224,996548,370008,950272,321816,46276,48192,520908,357468,1270784,138092,560,1450072,22196828
2024-11-20 06:53:11,1858332,48024,836,193432,18224,996500,370008,950224,321816,46276,48192,520908,357468,1270648,138112,560,1450072,22196856
2024-11-20 06:53:14,1858332,48028,836,193432,18224,996592,370008,950316,321816,46276,48192,520908,357468,1270768,138092,560,1450072,22196756
2024-11-20 06:53:16,1858332,47888,836,193432,18224,996916,370008,950640,321816,46276,48192,520908,357468,1271044,137908,560,1450072,22196620
2024-11-20 06:53:19,1858332,47620,836,193432,18224,997012,370008,950736,321816,46276,48192,520908,357468,1270956,138092,560,1450072,22196800
2024-11-20 06:53:21,1858332,47392,836,193432,18224,997044,370008,950768,321816,46276,48192,520908,357468,1271208,138144,560,1450072,22196760
2024-11-20 06:53:24,1858332,46788,836,193432,18224,997732,370012,951456,321820,46276,48192,520908,357472,1271820,138032,560,1450072,22196928
2024-11-20 06:53:26,1858332,46620,836,193432,18224,997892,370012,951616,321820,46276,48192,520908,357472,1272100,138092,560,1450072,22196976
2024-11-20 06:53:29,1858332,46504,836,193432,18224,998496,370012,952220,321820,46276,48192,520908,357472,1272692,138112,560,1450072,22196968
2024-11-20 06:53:32,1858332,45972,836,193432,18224,998836,370012,952560,321820,46276,48192,520908,357472,1273024,137908,560,1450072,22196928
2024-11-20 06:53:34,1858332,45404,836,193432,18224,999424,370012,953148,321820,46276,48192,520908,357472,1273572,138076,560,1450072,22196740
2024-11-20 06:53:37,1858332,44876,836,193432,18224,999660,370012,953384,321820,46276,48192,520908,357472,1274172,138092,560,1450072,22196672
2024-11-20 06:53:39,1858332,44360,836,193432,18224,1000456,370012,954180,321820,46276,48192,520908,357472,1274940,138108,560,1450072,22196792
2024-11-20 06:53:42,1858332,43752,836,193432,18224,1001048,370012,954772,321820,46276,48192,520908,357472,1275144,138140,560,1450072,22196908
2024-11-20 06:53:45,1858332,43420,836,193432,18224,1000944,370012,954668,321820,46276,48192,520908,357472,1275264,138092,560,1450072,22196860
2024-11-20 06:53:47,1858332,43540,836,193432,18224,1001084,370012,954808,321820,46276,48192,520908,357472,1275444,138112,560,1450072,22196860
2024-11-20 06:53:50,1858332,43040,836,193432,18224,1001700,370012,955424,321820,46276,48192,520908,357472,1275704,138096,560,1450072,22196772
2024-11-20 06:53:53,1858332,42848,836,193432,18224,1001612,370012,955336,321820,46276,48192,520908,357472,1275620,137908,560,1450072,22196768
2024-11-20 06:53:55,1858332,43020,836,193432,18224,1001732,370012,955456,321820,46276,48192,520908,357472,1275864,138112,560,1450072,22196836
2024-11-20 06:53:58,1858332,42752,836,193432,18224,1001872,370012,955596,321820,46276,48192,520908,357472,1275984,138092,560,1450072,22196944
2024-11-20 06:54:00,1858332,42308,836,193432,18224,1002324,370012,956048,321820,46276,48192,520908,357472,1276548,138140,560,1450072,22196772
2024-11-20 06:54:03,1858332,42292,836,193432,18224,1002460,370012,956184,321820,46276,48192,520908,357472,1276472,138092,560,1450072,22196856
2024-11-20 06:54:05,1858332,42008,836,193432,18224,1002704,370012,956428,321820,46276,48192,520908,357492,1277120,138144,560,1450072,22196912
2024-11-20 06:54:08,1858332,41864,836,193432,18224,1003244,370012,956968,321820,46276,48192,520908,357492,1277364,138116,560,1450072,22196860
2024-11-20 06:54:11,1858332,47560,836,193432,18224,997364,370012,951088,321820,46276,48192,520908,357492,1271652,138092,560,1450072,22196824
2024-11-20 06:54:13,1858332,46928,836,193432,18224,997992,370012,951716,321820,46276,48192,520908,357492,1271856,138112,560,1450072,22196908
2024-11-20 06:54:16,1858332,47236,836,193432,18224,997960,370012,951684,321820,46276,48192,520908,357492,1272024,138092,560,1450072,22196836
2024-11-20 06:54:19,1858332,46760,836,193432,18224,998136,370012,951860,321820,46276,48192,520908,357492,1272332,138092,560,1450072,22196848
2024-11-20 06:54:21,1858332,45972,836,193432,18224,998700,370036,952424,321844,46276,48192,520908,357916,1273040,138140,560,1450072,22196932
2024-11-20 06:54:24,1858332,46132,836,193432,18224,998824,370036,952548,321844,46276,48192,520908,357916,1273012,138092,560,1450072,22196732
2024-11-20 06:54:26,1858332,45712,836,193432,18224,998844,370036,952568,321844,46276,48192,520908,357916,1273228,138092,560,1450072,22196936
2024-11-20 06:54:29,1858332,45856,836,193432,18224,999172,370036,952896,321844,46276,48192,520908,357916,1273404,138092,560,1450072,22196732
2024-11-20 06:54:31,1858332,45540,836,193432,18224,999328,370036,953052,321844,46276,48192,520908,357916,1273352,137928,560,1450072,22196912
2024-11-20 06:54:34,1858332,45444,836,193432,18224,999604,370036,953328,321844,46276,48192,520908,357916,1273588,138032,560,1450072,22196840
2024-11-20 06:54:36,1858332,45300,836,193432,18224,999900,370036,953624,321844,46276,48192,520908,357916,1273928,138092,560,1450072,22196852
2024-11-20 06:54:39,1858332,44936,836,193432,18224,999860,370036,953584,321844,46276,48192,520908,357916,1274132,138056,560,1450072,22196828
2024-11-20 06:54:41,1858332,44460,836,193432,18224,1000168,370036,953892,321844,46276,48192,520908,357916,1274420,138092,560,1450072,22196876
2024-11-20 06:54:44,1858332,44568,836,193432,18224,1000200,370036,953924,321844,46276,48192,520908,357916,1274420,138092,560,1450072,22196872
2024-11-20 06:54:46,1858332,44448,836,193432,18224,1000444,370036,954168,321844,46276,48192,520908,357916,1274680,138092,560,1450072,22197004
2024-11-20 06:54:49,1858332,44248,836,193432,18224,1000500,370040,954224,321848,46276,48192,520908,357920,1274476,138276,560,1450072,22196980
2024-11-20 06:54:51,1858332,44200,836,193432,18224,1000856,370040,954580,321848,46276,48192,520908,357920,1275012,137996,560,1450072,22188568
2024-11-20 06:54:54,1858332,43476,836,193432,18224,1000876,370040,954600,321848,46276,48192,520908,357920,1275284,138276,560,1450072,22196816
2024-11-20 06:54:56,1858332,43372,836,193432,18224,1001512,370040,955236,321848,46276,48192,520908,357920,1275664,138112,560,1450072,22196692
2024-11-20 06:54:58,1858332,43272,836,193432,18224,1001392,370040,955116,321848,46276,48192,520908,357920,1275464,138092,560,1450072,22196728
2024-11-20 06:55:01,1858332,42856,836,193432,18224,1001548,370040,955272,321848,46276,48192,520908,357920,1275832,138092,560,1450072,22196780
2024-11-20 06:55:03,1858332,43036,836,193432,18224,1001724,370040,955448,321848,46276,48192,520908,357920,1275704,137944,560,1450072,22196960
2024-11-20 06:55:06,1858332,42580,836,193432,18224,1001972,370040,955696,321848,46276,48192,520908,357920,1276108,138084,560,1450072,22196892
2024-11-20 06:55:09,1858332,42472,836,193432,18224,1001948,370040,955672,321848,46276,48192,520908,357920,1276048,138092,560,1450072,22196776
2024-11-20 06:55:11,1858332,41948,836,193432,18224,1002456,370040,956180,321848,46276,48192,520908,357920,1276604,138080,560,1450072,22196756
2024-11-20 06:55:14,1858332,41796,836,193432,18224,1002484,370040,956208,321848,46276,48192,520908,357920,1276552,138092,560,1450072,22196872
2024-11-20 06:55:16,1858332,41868,836,193432,18224,1002684,370040,956408,321848,46276,48192,520908,357920,1276804,138120,560,1450072,22196952
2024-11-20 06:55:19,1858332,41804,836,193432,18224,1002760,370040,956484,321848,46276,48192,520908,357920,1276992,138092,560,1450072,22196876
2024-11-20 06:55:21,1858332,41244,836,193432,18224,1003308,370040,957032,321848,46276,48192,520908,357920,1277408,138112,560,1450072,22196948
2024-11-20 06:55:24,1858332,46672,836,193432,18224,997076,370040,950800,321848,46276,48192,520908,357920,1271448,137908,560,1450072,22196856
2024-11-20 06:55:26,1858332,46524,836,193432,18224,997460,370040,951184,321848,46276,48192,520908,357920,1271804,137908,560,1450072,22196740
2024-11-20 06:55:29,1858332,46800,836,193432,18224,997292,370040,951016,321848,46276,48192,520908,357920,1271484,137908,560,1450072,22196904
2024-11-20 06:55:31,1858332,46516,836,193432,18224,998040,370040,951764,321848,46276,48192,520908,357920,1272116,138092,560,1450072,22196864
2024-11-20 06:55:34,1858332,46328,836,193432,18224,998336,370040,952060,321848,46276,48192,520908,357920,1272580,138096,560,1450072,22196988
2024-11-20 06:55:36,1858332,45820,836,193432,18224,998492,370040,952216,321848,46276,48192,520908,357920,1272776,138148,560,1450072,22196744
2024-11-20 06:55:39,1858332,45924,836,193432,18224,998896,370040,952620,321848,46276,48192,520908,357920,1272944,138096,560,1450072,22196880
2024-11-20 06:55:42,1858332,45600,836,193432,18224,999244,370040,952968,321848,46276,48192,520908,357920,1273576,137780,560,1450072,22196900
2024-11-20 06:55:44,1858332,45640,836,193432,18224,999324,370040,953048,321848,46276,48192,520908,357920,1273324,138036,560,1450072,22196948
2024-11-20 06:55:47,1858332,45556,836,193432,18224,999216,370040,952940,321848,46276,48192,520908,357920,1273248,138096,560,1450072,22196928
2024-11-20 06:55:49,1858332,44420,836,193432,18224,1000112,370040,953836,321848,46276,48192,520908,357920,1274252,138116,560,1450072,22196792
2024-11-20 06:55:52,1858332,44416,836,193432,18224,1000000,370040,953724,321848,46276,48192,520908,357920,1274236,137912,560,1450072,22196792
2024-11-20 06:55:54,1858332,44072,836,193432,18224,1000268,370040,953992,321848,46276,48192,520908,357920,1274500,138096,560,1450072,22188696
2024-11-20 06:55:56,1858332,51088,944,201548,18052,992840,372452,945524,317092,47316,55360,520908,357664,1260912,131712,556,1450072,20145432
2024-11-20 06:55:58,1858332,50652,944,201548,18052,993076,372468,945756,317092,47320,55376,520908,357664,1261260,131768,556,1450072,20145464
2024-11-20 06:56:00,1858332,50980,944,201548,18052,993088,372048,945768,316672,47320,55376,520908,357664,1260808,131768,556,1450072,20145368
2024-11-20 06:56:02,1858332,55508,952,201548,18052,988436,372048,941116,316672,47320,55376,520908,357664,1256272,131768,556,1450072,20145472
2024-11-20 06:56:04,1858332,54876,952,201548,18052,988928,372060,941608,316676,47320,55384,520908,357668,1256632,131768,556,1450072,20145344
2024-11-20 06:56:07,1858332,55472,952,201548,18052,988480,372052,941160,316668,47320,55384,520908,357676,1256300,131768,556,1450072,20145452
2024-11-20 06:56:09,1858332,55576,952,201548,18052,988460,372052,941140,316668,47320,55384,520908,357680,1256092,131768,556,1450072,20145440
2024-11-20 06:56:11,1858332,55360,952,201548,18052,988700,372056,941380,316672,47320,55384,520908,357680,1256336,131768,556,1450072,20145488
2024-11-20 06:56:13,1858332,55044,952,201548,18048,988960,372076,941640,316692,47320,55384,520908,357704,1256752,131768,556,1450072,20145396
2024-11-20 06:56:15,1858332,54784,952,201548,18048,989008,372076,941688,316692,47320,55384,520908,357704,1256828,131820,556,1450072,20145500
2024-11-20 06:56:17,1858332,54556,952,201548,18048,989264,372076,941944,316692,47320,55384,520908,357704,1257008,131768,556,1450072,20145492
