Timestamp,MemTotal,MemFree,Buffers,Cached,SwapCached,Active,Inactive,Active(anon),Inactive(anon),Active(file),Inactive(file),SwapTotal,SwapFree,AnonPages,Mapped,Shmem,CommitLimit,Committed_AS
2024-11-20 05:51:00,1858332,1149112,556,213376,17868,106628,125684,70140,48196,36488,77488,520908,355288,116612,146408,712,1450072,22170160
2024-11-20 05:51:00,1858332,1149112,556,213376,17868,106628,125684,70140,48196,36488,77488,520908,355288,116612,146408,712,1450072,22170160
2024-11-20 05:51:00,1858332,1149112,556,213376,17868,106628,125684,70140,48196,36488,77488,520908,355288,116612,146408,712,1450072,22170160
2024-11-20 05:51:00,1858332,1149112,556,213376,17868,106628,125684,70140,48196,36488,77488,520908,355288,116612,146408,712,1450072,22170160
2024-11-20 05:51:00,1858332,1149112,556,213376,17868,106628,125684,70140,48196,36488,77488,520908,355288,116612,146408,712,1450072,22170160
2024-11-20 05:51:00,1858332,1149112,556,213376,17868,106628,125684,70140,48196,36488,77488,520908,355288,116612,146408,712,1450072,22170160
2024-11-20 05:51:00,1858332,1149112,556,213376,17868,106628,125684,70140,48196,36488,77488,520908,355288,116612,146408,712,1450072,22170160
2024-11-20 05:51:00,1858332,1149112,556,213376,17868,106628,125684,70140,48196,36488,77488,520908,355288,116612,146408,712,1450072,22170160
2024-11-20 05:51:00,1858332,1149112,556,213376,17868,106628,125684,70140,48196,36488,77488,520908,355288,116612,146408,712,1450072,22170160
2024-11-20 05:51:00,1858332,1149112,556,213376,17868,106628,125684,70140,48196,36488,77488,520908,355288,116612,146408,712,1450072,22170160
2024-11-20 05:51:00,1858332,1149112,556,213376,17868,106628,125684,70140,48196,36488,77488,520908,355288,116612,146408,712,1450072,22170160
2024-11-20 05:51:02,1858332,1092108,792,234784,17872,148644,138800,104188,47692,44456,91108,520908,355460,150344,152980,712,1450072,22364460
2024-11-20 05:51:04,1858332,1059732,792,235152,17872,181104,139228,136648,47688,44456,91540,520908,355460,182752,152864,712,1450072,22396756
2024-11-20 05:51:06,1858332,298832,792,504300,17872,881876,197980,627096,47684,254780,150296,520908,355496,673340,153172,712,1450072,23177856
2024-11-20 05:51:09,1858332,32524,120,238908,17908,1015788,336292,948588,264716,67200,71576,520908,353772,1211700,138556,712,1450072,22164196
2024-11-20 05:51:11,1858332,36316,232,195972,18056,1013276,339848,967816,289148,45460,50700,520908,353824,1255176,137532,708,1450072,22178172
2024-11-20 05:51:13,1858332,33908,332,201232,18052,996908,370392,949556,316576,47352,53816,520908,353120,1264540,144264,708,1450072,24099752
2024-11-20 05:51:16,1858332,29644,512,192908,17824,997164,363772,951120,316672,46044,47100,520908,351104,1266092,147816,708,1450072,22180604
2024-11-20 05:51:18,1858332,52536,496,186244,16356,981192,359380,937904,315980,43288,43400,520908,350248,1252848,137268,708,1450072,20258228
2024-11-20 05:51:20,1858332,49684,500,186468,16620,982552,359856,939264,316060,43288,43796,520908,350420,1254704,138252,708,1450072,22178072
2024-11-20 05:51:23,1858332,40672,596,192040,17276,995864,358672,944844,317040,51020,41632,520908,350908,1259964,144156,708,1450072,22179476
2024-11-20 05:51:25,1858332,39100,604,195536,17344,996296,360344,944312,316172,51984,44172,520908,350916,1258656,144296,708,1450072,22179296
2024-11-20 05:51:27,1858332,33904,604,200176,17344,996700,364756,944688,316080,52012,48676,520908,350916,1259132,144392,708,1450072,22179260
2024-11-20 05:51:30,1858332,41260,588,204484,17340,992004,367288,939120,315048,52884,52240,520908,350928,1252244,138064,708,1450072,20258176
2024-11-20 05:51:32,1858332,36384,588,208360,17336,992860,371136,939976,315044,52884,56092,520908,350932,1253076,138704,708,1450072,20258152
2024-11-20 05:51:35,1858332,38156,588,208160,17296,993900,369792,941016,313876,52884,55916,520908,350844,1253028,138616,708,1450072,20258180
2024-11-20 05:51:37,1858332,37744,528,209144,17288,994292,370584,941408,313752,52884,56832,520908,350808,1253388,138868,708,1450072,20258108
2024-11-20 05:51:40,1858332,36208,540,208360,17052,997096,370220,944032,314352,53064,55868,520908,350640,1256828,143124,708,1450072,22179696
2024-11-20 05:51:43,1858332,34664,544,202428,15920,1000872,367608,949136,316488,51736,51120,520908,349176,1263744,148656,708,1450072,24100516
2024-11-20 05:51:45,1858332,36040,552,200084,15236,1000468,367640,950156,317112,50312,50528,520908,348324,1265948,150856,564,1450072,24101368
2024-11-20 05:51:48,1858332,47724,452,191552,14416,984596,358764,936404,314748,48192,44016,520908,345512,1247456,140404,556,1450072,22180472
2024-11-20 05:51:51,1858332,51616,464,191568,14416,982212,358756,934004,314724,48208,44032,520908,345524,1246936,139124,552,1450072,20258000
2024-11-20 05:51:53,1858332,51752,464,191576,14416,982320,358752,934112,314712,48208,44040,520908,345532,1247384,139172,552,1450072,20258044
2024-11-20 05:51:55,1858332,48828,464,194076,14416,982568,361216,934360,314668,48208,46548,520908,345540,1247348,139156,552,1450072,20258096
2024-11-20 05:51:58,1858332,48260,464,194124,14416,982944,361248,934736,314660,48208,46588,520908,345540,1247668,139388,552,1450072,20258120
2024-11-20 05:52:00,1858332,47564,472,195400,14420,982772,362364,934564,314660,48208,47704,520908,345540,1247588,139468,552,1450072,20258116
2024-11-20 05:52:03,1858332,47256,472,195996,14416,983136,362560,934928,314124,48208,48436,520908,345556,1247176,139204,552,1450072,20258108
2024-11-20 05:52:05,1858332,46584,472,196068,14416,983460,362648,935252,314124,48208,48524,520908,345556,1247568,139484,552,1450072,20258088
2024-11-20 05:52:08,1858332,46408,472,196068,14416,983724,362668,935516,314128,48208,48540,520908,345572,1247908,139396,552,1450072,20258132
2024-11-20 05:52:10,1858332,46208,472,196068,14416,983956,362648,935748,314108,48208,48540,520908,345572,1248132,139660,552,1450072,20258052
2024-11-20 05:52:13,1858332,46424,472,196068,14416,984016,362648,935808,314108,48208,48540,520908,345612,1248296,139580,552,1450072,20258084
2024-11-20 05:52:15,1858332,46104,472,196068,14416,984256,362648,936048,314108,48208,48540,520908,345612,1248452,139448,552,1450072,20258124
2024-11-20 05:52:18,1858332,46292,472,196068,14416,984080,362648,935872,314108,48208,48540,520908,345612,1248224,139396,552,1450072,20258164
2024-11-20 05:52:20,1858332,46196,472,196068,14416,984364,362648,936156,314108,48208,48540,520908,345612,1248576,139332,552,1450072,20258060
2024-11-20 05:52:23,1858332,45952,472,196068,14416,984868,362648,936660,314108,48208,48540,520908,345612,1248928,139456,552,1450072,20258044
2024-11-20 05:52:26,1858332,45684,472,196068,14416,984812,362648,936604,314108,48208,48540,520908,345612,1248984,139400,552,1450072,20258184
2024-11-20 05:52:28,1858332,45472,472,196068,14416,985112,362648,936904,314108,48208,48540,520908,345612,1249276,139524,552,1450072,20258020
2024-11-20 05:52:31,1858332,45816,472,196068,14416,985008,362648,936800,314108,48208,48540,520908,345612,1249092,139400,552,1450072,20258048
2024-11-20 05:52:33,1858332,45060,472,196164,14416,985432,362744,937224,314108,48208,48636,520908,345612,1249712,139524,552,1450072,20258072
2024-11-20 05:52:36,1858332,45220,472,196164,14416,985400,362744,937192,314108,48208,48636,520908,345612,1249368,139220,552,1450072,20258176
2024-11-20 05:52:38,1858332,44072,472,196164,14412,986128,362744,937920,314108,48208,48636,520908,345616,1250392,139524,552,1450072,20258136
2024-11-20 05:52:41,1858332,51756,472,196164,14412,978232,362480,930008,313860,48224,48620,520908,345640,1242136,138668,552,1450072,20258188
2024-11-20 05:52:43,1858332,52140,472,196164,14412,978216,362476,929992,313856,48224,48620,520908,345640,1242084,138712,552,1450072,20258004
2024-11-20 05:52:46,1858332,51512,472,196348,14412,978652,362600,930428,313856,48224,48744,520908,345640,1242472,138652,552,1450072,20258148
2024-11-20 05:52:48,1858332,51692,472,196312,14412,978648,362624,930424,313856,48224,48768,520908,345640,1242584,138664,552,1450072,20258100
2024-11-20 05:52:51,1858332,51532,472,196312,14412,978604,362624,930380,313856,48224,48768,520908,345644,1242528,138664,552,1450072,20258092
2024-11-20 05:52:53,1858332,49812,472,196312,14412,979744,362624,931520,313856,48224,48768,520908,345656,1243672,138928,552,1450072,22177888
2024-11-20 05:52:56,1858332,43228,480,196560,14412,985780,362892,937508,313916,48272,48976,520908,345812,1249800,143744,552,1450072,24099372
2024-11-20 05:52:59,1858332,34232,496,195456,14412,993768,363388,945716,315360,48052,48028,520908,344860,1259760,148924,560,1450072,24100740
2024-11-20 05:53:01,1858332,35576,600,195216,14420,990428,362692,941772,315588,48656,47104,520908,344112,1255656,148444,552,1450072,24101780
2024-11-20 05:53:04,1858332,36652,584,193480,14408,992776,359948,944256,314196,48520,45752,520908,343784,1257224,149056,552,1450072,22180628
2024-11-20 05:53:07,1858332,36680,592,193472,14412,992772,359952,944252,314200,48520,45752,520908,343788,1257240,149048,552,1450072,22180792
2024-11-20 05:53:09,1858332,36624,592,193480,14412,993112,359968,944592,314208,48520,45760,520908,343792,1257364,148988,552,1450072,22180708
2024-11-20 05:53:12,1858332,36420,592,193480,14412,993012,359968,944492,314208,48520,45760,520908,343848,1257472,149048,552,1450072,22180620
2024-11-20 05:53:14,1858332,38780,592,193480,14412,990776,359968,942256,314208,48520,45760,520908,344032,1255036,149164,552,1450072,22180612
2024-11-20 05:53:17,1858332,38980,592,193480,14412,990740,359988,942220,314228,48520,45760,520908,344036,1255164,148752,552,1450072,22180640
2024-11-20 05:53:19,1858332,38916,592,193480,14412,990732,359976,942212,314216,48520,45760,520908,344036,1255028,149156,552,1450072,22180592
2024-11-20 05:53:22,1858332,38452,592,193476,14416,991148,359976,942628,314216,48520,45760,520908,344044,1255464,148936,552,1450072,22180636
2024-11-20 05:53:24,1858332,38532,592,193480,14416,991276,359952,942756,314192,48520,45760,520908,344044,1255420,148976,552,1450072,22180592
2024-11-20 05:53:27,1858332,38532,592,193480,14416,991208,359952,942688,314192,48520,45760,520908,344044,1255360,148940,552,1450072,22180580
2024-11-20 05:53:29,1858332,38080,592,193480,14416,991424,359948,942904,314188,48520,45760,520908,344044,1255772,148940,552,1450072,22180672
2024-11-20 05:53:32,1858332,37520,592,193480,14416,992076,359784,943556,314024,48520,45760,520908,344044,1255972,149012,552,1450072,22180464
2024-11-20 05:53:35,1858332,37840,592,193480,14416,992000,359784,943480,314024,48520,45760,520908,344044,1256036,148940,552,1450072,22180428
2024-11-20 05:53:37,1858332,37472,592,193480,14416,992104,359780,943584,314020,48520,45760,520908,344044,1256036,148992,552,1450072,22180696
2024-11-20 05:53:40,1858332,37132,592,193480,14416,992284,359780,943764,314020,48520,45760,520908,344044,1256452,148940,552,1450072,22180684
2024-11-20 05:53:42,1858332,37312,592,193480,14416,992276,359780,943756,314020,48520,45760,520908,344044,1256328,148864,552,1450072,22180560
2024-11-20 05:53:45,1858332,36868,592,193480,14416,992548,359780,944028,314020,48520,45760,520908,344044,1256716,148944,552,1450072,22180616
2024-11-20 05:53:47,1858332,36744,592,193480,14416,992940,359780,944420,314020,48520,45760,520908,344044,1257072,148944,552,1450072,22180556
2024-11-20 05:53:50,1858332,36620,592,193480,14416,993160,359780,944640,314020,48520,45760,520908,344044,1257108,148944,552,1450072,22180444
2024-11-20 05:53:52,1858332,46504,592,191084,14376,984108,359648,935816,316048,48292,43600,520908,344044,1250248,138848,552,1450072,20258052
2024-11-20 05:53:55,1858332,45552,592,191528,14400,984864,359996,936516,316132,48348,43864,520908,344088,1250888,138928,548,1450072,20258320
2024-11-20 05:53:57,1858332,45668,600,191464,14400,985172,360064,936824,316136,48348,43928,520908,344092,1251060,139056,548,1450072,20258068
2024-11-20 05:54:00,1858332,45384,600,191472,14400,985172,360072,936824,316136,48348,43936,520908,344092,1251268,139052,548,1450072,20258164
2024-11-20 05:54:02,1858332,45276,600,191472,14400,985400,360076,937052,316140,48348,43936,520908,344096,1251436,138800,548,1450072,20258156
2024-11-20 05:54:05,1858332,45148,600,191472,14400,985276,360076,936928,316140,48348,43936,520908,344096,1251532,138868,548,1450072,20257980
2024-11-20 05:54:07,1858332,44616,600,191472,14400,985980,360080,937632,316144,48348,43936,520908,344104,1251996,138892,548,1450072,20258188
2024-11-20 05:54:10,1858332,44164,600,191472,14400,986536,360084,938188,316148,48348,43936,520908,344104,1252528,138984,548,1450072,20258196
2024-11-20 05:54:13,1858332,43712,600,191472,14400,987020,360088,938672,316152,48348,43936,520908,344192,1253188,138684,548,1450072,20258104
2024-11-20 05:54:15,1858332,42908,600,191472,14400,987824,360092,939476,316156,48348,43936,520908,344192,1253776,138876,548,1450072,20258056
2024-11-20 05:54:18,1858332,48892,600,191472,14400,981608,360092,933260,316156,48348,43936,520908,344236,1247460,139060,548,1450072,20258204
2024-11-20 05:54:21,1858332,49216,600,191472,14400,981404,360092,933056,316156,48348,43936,520908,344236,1247580,139060,548,1450072,20258036
2024-11-20 05:54:23,1858332,49168,600,191472,14400,981364,360092,933016,316156,48348,43936,520908,344236,1247472,138972,548,1450072,20258124
2024-11-20 05:54:26,1858332,48808,600,191472,14400,981616,360096,933268,316160,48348,43936,520908,344240,1247724,138884,548,1450072,20258088
2024-11-20 05:54:28,1858332,48656,600,191472,14400,981752,360096,933404,316160,48348,43936,520908,344240,1247924,138884,548,1450072,20258168
2024-11-20 05:54:30,1858332,48896,600,191472,14400,981956,360096,933608,316160,48348,43936,520908,344240,1248180,138960,548,1450072,20258244
2024-11-20 05:54:33,1858332,48920,600,191472,14400,982188,360096,933840,316160,48348,43936,520908,344240,1248208,138884,548,1450072,20258212
2024-11-20 05:54:35,1858332,48352,600,191472,14400,982432,360096,934084,316160,48348,43936,520908,344240,1248704,138804,548,1450072,20258240
2024-11-20 05:54:38,1858332,48340,600,191472,14400,982532,360096,934184,316160,48348,43936,520908,344240,1248664,138884,548,1450072,20258236
2024-11-20 05:54:40,1858332,49668,600,191472,14400,981064,359956,932716,316020,48348,43936,520908,344348,1246756,138884,548,1450072,20258256
2024-11-20 05:54:43,1858332,49904,600,191472,14400,981152,359856,932804,315920,48348,43936,520908,344348,1247084,138884,548,1450072,20258092
2024-11-20 05:54:45,1858332,49936,600,191472,14400,980864,359856,932516,315920,48348,43936,520908,344348,1246788,138912,548,1450072,20258004
2024-11-20 05:54:48,1858332,49816,600,191472,14400,981180,359856,932832,315920,48348,43936,520908,344348,1246952,139068,548,1450072,20258252
2024-11-20 05:54:50,1858332,49680,600,191472,14400,981444,359856,933096,315920,48348,43936,520908,344348,1247404,139024,548,1450072,20258268
2024-11-20 05:54:53,1858332,49740,600,191472,14400,981368,359856,933020,315920,48348,43936,520908,344348,1247272,138884,548,1450072,20258184
2024-11-20 05:54:55,1858332,49496,600,191472,14400,981940,359856,933592,315920,48348,43936,520908,344348,1247752,138996,548,1450072,20258172
2024-11-20 05:54:58,1858332,48912,600,191472,14400,982168,359856,933820,315920,48348,43936,520908,344348,1248192,138888,548,1450072,20258060
2024-11-20 05:55:00,1858332,46636,600,192052,14400,984308,360156,935960,315676,48348,44480,520908,344352,1249952,139116,548,1450072,20267888
2024-11-20 05:55:03,1858332,46880,600,192052,14400,984168,360108,935820,315592,48348,44516,520908,344352,1249840,139144,548,1450072,20267932
2024-11-20 05:55:05,1858332,46696,600,192052,14400,984628,360108,936280,315592,48348,44516,520908,344352,1250124,139060,548,1450072,20267876
2024-11-20 05:55:08,1858332,46244,600,192052,14400,984876,360112,936528,315596,48348,44516,520908,344356,1250452,138960,548,1450072,20267748
2024-11-20 05:55:10,1858332,46440,600,192052,14400,985044,360112,936696,315596,48348,44516,520908,344356,1250532,138992,548,1450072,20267664
2024-11-20 05:55:13,1858332,45940,600,192052,14400,985068,360112,936720,315596,48348,44516,520908,344356,1250496,138960,548,1450072,20267876
2024-11-20 05:55:15,1858332,45860,600,192052,14400,985320,360112,936972,315596,48348,44516,520908,344356,1250812,139060,548,1450072,20267884
2024-11-20 05:55:18,1858332,45692,600,192052,14400,985128,360112,936780,315596,48348,44516,520908,344356,1250624,138960,548,1450072,20267992
2024-11-20 05:55:20,1858332,44812,600,192052,14400,985716,360116,937368,315600,48348,44516,520908,344360,1251192,138916,548,1450072,20268000
2024-11-20 05:55:23,1858332,45100,600,192052,14400,985736,360116,937388,315600,48348,44516,520908,344360,1251296,139144,548,1450072,20267840
2024-11-20 05:55:25,1858332,45084,600,192052,14400,985860,360116,937512,315600,48348,44516,520908,344360,1251364,138960,548,1450072,20267820
2024-11-20 05:55:28,1858332,44604,600,192052,14400,985752,360116,937404,315600,48348,44516,520908,344360,1251372,139144,548,1450072,20267872
2024-11-20 05:55:30,1858332,44764,600,192052,14400,986328,360116,937980,315600,48348,44516,520908,344360,1251776,138916,548,1450072,20259584
2024-11-20 05:55:32,1858332,44376,600,192052,14400,986552,360116,938204,315600,48348,44516,520908,344360,1251948,138960,548,1450072,20267876
2024-11-20 05:55:35,1858332,43948,600,192052,14400,986576,360116,938228,315600,48348,44516,520908,344360,1252132,138960,548,1450072,20267936
2024-11-20 05:55:38,1858332,44336,600,192052,14400,986344,360116,937996,315600,48348,44516,520908,344360,1251848,139144,548,1450072,20267928
2024-11-20 05:55:40,1858332,43808,600,192052,14400,986968,360116,938620,315600,48348,44516,520908,344360,1252596,138948,548,1450072,20267840
2024-11-20 05:55:43,1858332,43904,600,192052,14400,986820,360116,938472,315600,48348,44516,520908,344360,1252344,138776,548,1450072,20267888
2024-11-20 05:55:45,1858332,44168,600,192052,14400,987004,360116,938656,315600,48348,44516,520908,344360,1252804,139096,548,1450072,20267716
2024-11-20 05:55:48,1858332,43536,600,192052,14400,987460,360116,939112,315600,48348,44516,520908,344364,1253004,139144,548,1450072,20267980
2024-11-20 05:55:50,1858332,43220,600,192052,14400,987348,360124,939000,315608,48348,44516,520908,344368,1252992,139028,548,1450072,20267868
2024-11-20 05:55:53,1858332,43088,600,192052,14400,987420,360124,939072,315608,48348,44516,520908,344368,1252968,138960,548,1450072,20267888
2024-11-20 05:55:55,1858332,42584,600,192052,14400,988276,360124,939928,315608,48348,44516,520908,344368,1254032,139040,548,1450072,20267984
2024-11-20 05:55:57,1858332,49592,600,192052,14400,981680,360124,933332,315608,48348,44516,520908,344408,1247188,138968,548,1450072,20267900
2024-11-20 05:56:00,1858332,49024,600,192052,14400,981744,360124,933396,315608,48348,44516,520908,344408,1247240,139100,548,1450072,20267852
2024-11-20 05:56:02,1858332,49360,600,192052,14400,981392,360124,933044,315608,48348,44516,520908,344408,1246900,138784,548,1450072,20267792
2024-11-20 05:56:05,1858332,49044,600,192052,14400,981856,360124,933508,315608,48348,44516,520908,344408,1247352,138928,548,1450072,20267632
2024-11-20 05:56:07,1858332,49072,600,192052,14400,981788,360124,933440,315608,48348,44516,520908,344408,1246992,138784,548,1450072,20259684
2024-11-20 05:56:10,1858332,48532,600,192052,14400,982280,360124,933932,315608,48348,44516,520908,344408,1247652,138968,548,1450072,20267744
2024-11-20 05:56:12,1858332,48408,600,192052,14400,982780,360124,934432,315608,48348,44516,520908,344408,1248176,139004,548,1450072,20267924
2024-11-20 05:56:15,1858332,48276,600,192052,14400,982836,360124,934488,315608,48348,44516,520908,344408,1248284,139152,548,1450072,20267832
2024-11-20 05:56:17,1858332,48084,600,192052,14400,983036,360124,934688,315608,48348,44516,520908,344408,1248608,138824,548,1450072,20267760
2024-11-20 05:56:20,1858332,47896,600,192052,14400,983056,360124,934708,315608,48348,44516,520908,344408,1248580,138784,548,1450072,20267872
2024-11-20 05:56:22,1858332,47716,600,192052,14400,983192,360124,934844,315608,48348,44516,520908,344408,1248940,139056,548,1450072,20267636
2024-11-20 05:56:25,1858332,47188,600,192052,14400,983812,360124,935464,315608,48348,44516,520908,344408,1249536,139088,548,1450072,20267772
2024-11-20 05:56:28,1858332,47032,600,192052,14400,983964,360124,935616,315608,48348,44516,520908,344408,1249532,138784,548,1450072,20267800
2024-11-20 05:56:30,1858332,46504,600,192052,14400,984256,360124,935908,315608,48348,44516,520908,344408,1249972,139076,548,1450072,20267984
2024-11-20 05:56:33,1858332,45624,600,193060,14404,984644,361104,936296,315616,48348,45488,520908,344412,1250160,139196,548,1450072,20267848
2024-11-20 05:56:36,1858332,45244,600,193060,14404,984724,361140,936376,315616,48348,45524,520908,344412,1250320,139152,548,1450072,20267912
2024-11-20 05:56:38,1858332,45264,600,193060,14404,984724,361140,936376,315616,48348,45524,520908,344412,1250180,139244,548,1450072,20267708
2024-11-20 05:56:41,1858332,44756,600,193060,14404,985216,361140,936868,315616,48348,45524,520908,344412,1250652,139152,548,1450072,20267728
2024-11-20 05:56:43,1858332,44316,600,193060,14404,985240,361140,936892,315616,48348,45524,520908,344412,1250608,139216,548,1450072,20267756
2024-11-20 05:56:46,1858332,44160,600,193060,14404,985380,361140,937032,315616,48348,45524,520908,344412,1250736,139336,548,1450072,20267900
2024-11-20 05:56:48,1858332,43744,600,193060,14404,986020,361140,937672,315616,48348,45524,520908,344412,1251452,139204,548,1450072,20267772
2024-11-20 05:56:51,1858332,43572,600,193060,14404,986188,361140,937840,315616,48348,45524,520908,344412,1251620,139152,548,1450072,20267992
2024-11-20 05:56:53,1858332,42488,600,193060,14404,987200,361144,938852,315620,48348,45524,520908,344448,1252724,139400,548,1450072,20267928
2024-11-20 05:56:56,1858332,42228,600,193236,14404,987532,361324,939184,315624,48348,45700,520908,344452,1253136,139328,548,1450072,20267920
2024-11-20 05:56:59,1858332,41908,600,193236,14404,987508,361324,939160,315624,48348,45700,520908,344452,1253144,139176,548,1450072,20267828
2024-11-20 05:57:01,1858332,41492,600,193232,14408,987872,361328,939524,315628,48348,45700,520908,344460,1253608,139320,548,1450072,20275932
2024-11-20 05:57:04,1858332,41336,600,193236,14408,988408,361336,940060,315636,48348,45700,520908,344460,1253968,139200,548,1450072,20276124
2024-11-20 05:57:07,1858332,47652,600,193236,14408,982028,361332,933680,315632,48348,45700,520908,344468,1247612,139176,548,1450072,20275976
2024-11-20 05:57:09,1858332,47352,600,193236,14408,982388,361340,934040,315640,48348,45700,520908,344468,1247852,139304,548,1450072,20276060
2024-11-20 05:57:12,1858332,47504,600,193236,14408,982392,361340,934044,315640,48348,45700,520908,344468,1247816,139288,548,1450072,20275980
2024-11-20 05:57:15,1858332,47300,600,193236,14408,982408,361340,934060,315640,48348,45700,520908,344468,1248160,139176,548,1450072,20275960
2024-11-20 05:57:17,1858332,46756,600,193236,14408,983112,361340,934764,315640,48348,45700,520908,344468,1248688,139272,548,1450072,20275952
2024-11-20 05:57:20,1858332,46584,600,193236,14408,983052,361340,934704,315640,48348,45700,520908,344468,1248648,139176,548,1450072,20276052
2024-11-20 05:57:22,1858332,47044,600,193236,14408,982992,361340,934644,315640,48348,45700,520908,344468,1248552,139360,548,1450072,20275924
2024-11-20 05:57:25,1858332,46896,600,193236,14408,983468,361340,935120,315640,48348,45700,520908,344468,1248984,139260,548,1450072,20276040
2024-11-20 05:57:28,1858332,46608,600,193236,14408,983476,361340,935128,315640,48348,45700,520908,344468,1249036,139360,548,1450072,20276012
2024-11-20 05:57:30,1858332,46376,600,193236,14408,983596,361340,935248,315640,48348,45700,520908,344468,1249132,139292,548,1450072,20276008
2024-11-20 05:57:33,1858332,45904,600,193236,14408,983868,361340,935520,315640,48348,45700,520908,344468,1249456,139176,548,1450072,20276076
2024-11-20 05:57:35,1858332,45932,600,193236,14408,984096,361340,935748,315640,48348,45700,520908,344468,1249756,139360,548,1450072,20276100
2024-11-20 05:57:38,1858332,45752,600,193236,14408,984048,361340,935700,315640,48348,45700,520908,344468,1249768,139360,548,1450072,20276012
2024-11-20 05:57:40,1858332,45308,600,193236,14408,984500,361340,936152,315640,48348,45700,520908,344468,1250064,139112,548,1450072,20276060
2024-11-20 05:57:43,1858332,45500,600,193420,14408,984684,361588,936336,315640,48348,45948,520908,344472,1250268,139200,548,1450072,20276032
2024-11-20 05:57:46,1858332,41648,640,194956,14416,986900,363056,938496,315684,48404,47372,520908,346836,1252716,139608,552,1450072,20275996
2024-11-20 05:57:48,1858332,40896,640,194956,14416,987880,363088,939476,315688,48404,47400,520908,346840,1253240,139812,552,1450072,20276128
2024-11-20 05:57:51,1858332,40268,640,194956,14416,988000,363088,939596,315688,48404,47400,520908,346840,1253644,139792,552,1450072,20276028
2024-11-20 05:57:53,1858332,40336,640,194956,14416,988244,363092,939840,315692,48404,47400,520908,346844,1253832,139792,552,1450072,20276016
2024-11-20 05:57:56,1858332,39820,640,194956,14412,988684,363116,940280,315716,48404,47400,520908,346872,1254224,139816,552,1450072,20276104
2024-11-20 05:57:58,1858332,39712,640,194956,14412,988812,363116,940408,315716,48404,47400,520908,346872,1254436,139792,552,1450072,20276196
2024-11-20 05:58:01,1858332,39336,640,194956,14412,988968,363116,940564,315716,48404,47400,520908,346872,1254348,139976,552,1450072,20276000
2024-11-20 05:58:03,1858332,39456,640,194956,14412,988888,363116,940484,315716,48404,47400,520908,346872,1254360,139788,552,1450072,20275924
2024-11-20 05:58:06,1858332,39188,640,194956,14412,989092,363116,940688,315716,48404,47400,520908,346872,1254868,139608,552,1450072,20276044
2024-11-20 05:58:08,1858332,36916,640,194952,14416,990692,363116,942288,315716,48404,47400,520908,346872,1256432,140548,552,1450072,22195876
2024-11-20 05:58:11,1858332,33192,648,193768,14424,996864,362028,948464,315804,48400,46224,520908,346936,1262540,145268,552,1450072,24117364
2024-11-20 05:58:14,1858332,37364,648,191932,14424,995656,362560,948004,317356,47652,45204,520908,346940,1263240,147304,552,1450072,24118584
2024-11-20 05:58:16,1858332,38856,656,192056,14428,995332,362556,947580,317388,47752,45168,520908,346992,1263352,147384,552,1450072,22197188
2024-11-20 05:58:19,1858332,38420,656,192056,14428,995828,362556,948076,317388,47752,45168,520908,346992,1263696,147384,552,1450072,22197148
2024-11-20 05:58:22,1858332,37060,664,193124,14428,995660,363624,947908,317388,47752,46236,520908,347016,1263664,147368,552,1450072,22197196
2024-11-20 05:58:24,1858332,43648,664,193124,14428,988656,363656,940904,317412,47752,46244,520908,347016,1256932,146496,552,1450072,22197220
2024-11-20 05:58:27,1858332,43816,664,193124,14428,988908,363656,941156,317412,47752,46244,520908,347016,1256860,146616,552,1450072,22197080
2024-11-20 05:58:29,1858332,43456,664,193124,14428,989076,363656,941324,317412,47752,46244,520908,347016,1257036,146432,552,1450072,22197136
2024-11-20 05:58:32,1858332,43360,664,193124,14428,988988,363656,941236,317412,47752,46244,520908,347016,1257248,146616,552,1450072,22197140
2024-11-20 05:58:34,1858332,43444,664,193124,14428,989508,363656,941756,317412,47752,46244,520908,347016,1257768,146616,552,1450072,22196900
2024-11-20 05:58:37,1858332,43384,664,193124,14428,989668,363656,941916,317412,47752,46244,520908,347016,1257660,146636,552,1450072,22197316
2024-11-20 05:58:39,1858332,42748,664,193124,14428,989944,363656,942192,317412,47752,46244,520908,347016,1258044,146620,552,1450072,22197172
2024-11-20 05:58:42,1858332,42640,664,193124,14428,990324,363656,942572,317412,47752,46244,520908,347016,1258460,146644,552,1450072,22197068
2024-11-20 05:58:45,1858332,42560,664,193124,14428,990276,363656,942524,317412,47752,46244,520908,347016,1258520,146620,552,1450072,22197156
2024-11-20 05:58:47,1858332,42584,664,193124,14428,990348,363656,942596,317412,47752,46244,520908,347016,1258564,146640,552,1450072,22197280
2024-11-20 05:58:50,1858332,42280,664,193124,14428,990676,363656,942924,317412,47752,46244,520908,347016,1258784,146620,552,1450072,22197088
2024-11-20 05:58:52,1858332,42284,664,193124,14428,990924,363656,943172,317412,47752,46244,520908,347016,1258916,146480,552,1450072,22197172
2024-11-20 05:58:55,1858332,41640,664,193124,14428,991176,363656,943424,317412,47752,46244,520908,347016,1259300,146436,552,1450072,22197192
2024-11-20 05:58:58,1858332,41596,664,193124,14428,991376,363656,943624,317412,47752,46244,520908,347016,1259652,146436,552,1450072,22197152
2024-11-20 05:59:00,1858332,41440,664,193124,14428,991516,363656,943764,317412,47752,46244,520908,347016,1259688,146640,552,1450072,22197276
2024-11-20 05:59:02,1858332,41436,664,193124,14428,991268,363656,943516,317412,47752,46244,520908,347016,1259324,146620,552,1450072,22197144
2024-11-20 05:59:05,1858332,40916,664,193124,14428,991856,363656,944104,317412,47752,46244,520908,347016,1259872,146640,552,1450072,22197096
2024-11-20 05:59:08,1858332,40868,664,193124,14428,992288,363664,944536,317420,47752,46244,520908,347024,1260444,146620,552,1450072,22197236
2024-11-20 05:59:10,1858332,40264,664,193124,14428,992704,363664,944952,317420,47752,46244,520908,347024,1260600,146668,552,1450072,22197092
2024-11-20 05:59:13,1858332,39776,664,193124,14428,992920,363664,945168,317420,47752,46244,520908,347024,1260952,146436,552,1450072,22196956
2024-11-20 05:59:15,1858332,40008,664,193124,14428,992988,363664,945236,317420,47752,46244,520908,347024,1261096,146636,552,1450072,22197052
2024-11-20 05:59:18,1858332,39680,664,193124,14428,993496,363664,945744,317420,47752,46244,520908,347024,1261488,146620,552,1450072,22197060
2024-11-20 05:59:20,1858332,39608,664,193124,14428,993588,363664,945836,317420,47752,46244,520908,347024,1261620,146676,552,1450072,22196992
2024-11-20 05:59:22,1858332,39024,664,193124,14428,993872,363664,946120,317420,47752,46244,520908,347024,1261820,146624,552,1450072,22196944
2024-11-20 05:59:25,1858332,38872,664,193124,14428,994012,363664,946260,317420,47752,46244,520908,347024,1262204,146624,552,1450072,22197008
2024-11-20 05:59:27,1858332,38644,664,193124,14428,994160,363664,946408,317420,47752,46244,520908,347024,1262456,146624,552,1450072,22197028
2024-11-20 05:59:30,1858332,38208,664,193124,14428,994664,363664,946912,317420,47752,46244,520908,347024,1262832,146644,552,1450072,22196980
2024-11-20 05:59:32,1858332,37032,664,193120,14432,995772,363664,948020,317420,47752,46244,520908,347040,1263828,146440,552,1450072,22197128
2024-11-20 05:59:35,1858332,43164,664,193124,14432,989316,363684,941564,317440,47752,46244,520908,347040,1257456,146756,552,1450072,22197052
2024-11-20 05:59:38,1858332,42764,664,193124,14432,989728,363684,941976,317440,47752,46244,520908,347040,1257956,146756,552,1450072,22196988
2024-11-20 05:59:40,1858332,42892,664,193124,14432,989692,363684,941940,317440,47752,46244,520908,347040,1257836,146768,552,1450072,22197000
2024-11-20 05:59:43,1858332,42808,664,193124,14432,990004,363684,942252,317440,47752,46244,520908,347040,1257964,146756,552,1450072,22196868
2024-11-20 05:59:45,1858332,43048,664,193124,14432,990056,363692,942304,317448,47752,46244,520908,347048,1258260,146660,552,1450072,22197016
2024-11-20 05:59:48,1858332,42368,664,193124,14432,990344,363692,942592,317448,47752,46244,520908,347048,1258324,146756,552,1450072,22197076
2024-11-20 05:59:50,1858332,42368,664,193124,14432,990372,363692,942620,317448,47752,46244,520908,347048,1258448,146776,552,1450072,22197004
2024-11-20 05:59:53,1858332,41860,664,193124,14432,990752,363692,943000,317448,47752,46244,520908,347048,1258888,146572,552,1450072,22197100
2024-11-20 05:59:55,1858332,41712,664,193112,14444,990864,363692,943112,317448,47752,46244,520908,347060,1259052,146756,552,1450072,22197024
2024-11-20 05:59:58,1858332,41440,664,193124,14444,991384,363712,943632,317468,47752,46244,520908,347060,1259472,146740,552,1450072,22197032
2024-11-20 06:00:01,1858332,41416,664,193124,14444,991240,363712,943488,317468,47752,46244,520908,347060,1259268,146756,552,1450072,22197112
2024-11-20 06:00:03,1858332,40896,664,193124,14444,991476,363716,943724,317472,47752,46244,520908,347064,1259772,146756,552,1450072,22197052
2024-11-20 06:00:06,1858332,40764,664,193124,14444,991880,363716,944128,317472,47752,46244,520908,347064,1260152,146696,552,1450072,22197016
2024-11-20 06:00:09,1858332,40312,664,193124,14444,992276,363720,944524,317476,47752,46244,520908,347068,1260520,146756,552,1450072,22196916
2024-11-20 06:00:11,1858332,39812,664,193124,14444,992600,363720,944848,317476,47752,46244,520908,347068,1260728,146624,552,1450072,22196928
2024-11-20 06:00:14,1858332,39776,664,193124,14444,992744,363720,944992,317476,47752,46244,520908,347068,1260940,146748,552,1450072,22196820
2024-11-20 06:00:16,1858332,39692,664,193124,14444,992840,363720,945088,317476,47752,46244,520908,347068,1260960,146756,552,1450072,22196836
2024-11-20 06:00:19,1858332,39792,664,193124,14444,992940,363720,945188,317476,47752,46244,520908,347068,1261180,146776,552,1450072,22196796
2024-11-20 06:00:21,1858332,39724,664,193124,14444,993176,363720,945424,317476,47752,46244,520908,347068,1261176,146756,552,1450072,22196840
2024-11-20 06:00:24,1858332,39428,664,193124,14444,993488,363720,945736,317476,47752,46244,520908,347068,1261588,146764,552,1450072,22196952
2024-11-20 06:00:27,1858332,39344,664,193124,14444,993652,363720,945900,317476,47752,46244,520908,347068,1261968,146756,552,1450072,22197028
2024-11-20 06:00:29,1858332,38660,664,193124,14444,993880,363720,946128,317476,47752,46244,520908,347068,1262028,146776,552,1450072,22196928
2024-11-20 06:00:32,1858332,38432,664,193124,14444,993912,363720,946160,317476,47752,46244,520908,347068,1262128,146572,552,1450072,22196956
2024-11-20 06:00:35,1858332,38584,664,193124,14444,994000,363720,946248,317476,47752,46244,520908,347072,1262112,146600,552,1450072,22197052
2024-11-20 06:00:37,1858332,38268,664,193124,14444,994096,363724,946344,317480,47752,46244,520908,347072,1262240,146572,552,1450072,22197048
2024-11-20 06:00:39,1858332,37936,664,193124,14444,994500,363724,946748,317480,47752,46244,520908,347072,1262444,146776,552,1450072,22197100
2024-11-20 06:00:42,1858332,37872,664,193124,14444,994704,363724,946952,317480,47752,46244,520908,347072,1262856,146776,552,1450072,22197052
2024-11-20 06:00:45,1858332,37416,664,193124,14444,994972,363724,947220,317480,47752,46244,520908,347072,1263120,146756,552,1450072,22197048
2024-11-20 06:00:47,1858332,37452,664,193124,14444,994980,363724,947228,317480,47752,46244,520908,347072,1262912,146808,552,1450072,22197068
2024-11-20 06:00:50,1858332,37008,664,193124,14444,995388,363724,947636,317480,47752,46244,520908,347072,1263460,146756,552,1450072,22196924
2024-11-20 06:00:52,1858332,36952,664,193124,14444,995224,363724,947472,317480,47752,46244,520908,347072,1263260,146748,552,1450072,22196948
2024-11-20 06:00:54,1858332,36788,664,193124,14444,995304,363724,947552,317480,47752,46244,520908,347072,1263476,146756,552,1450072,22196900
2024-11-20 06:00:57,1858332,36888,664,193124,14448,995692,363732,947940,317488,47752,46244,520908,347076,1263588,146756,552,1450072,22197028
2024-11-20 06:00:59,1858332,36748,664,193124,14448,995740,363732,947988,317488,47752,46244,520908,347076,1263988,146776,552,1450072,22197008
2024-11-20 06:01:01,1858332,36568,664,193124,14448,995936,363732,948184,317488,47752,46244,520908,347076,1264076,146572,552,1450072,22196964
2024-11-20 06:01:04,1858332,36244,664,193124,14448,996320,363732,948568,317488,47752,46244,520908,347076,1264272,146756,552,1450072,22196888
2024-11-20 06:01:06,1858332,36028,664,193124,14448,996780,363732,949028,317488,47752,46244,520908,347076,1264788,146572,552,1450072,22196864
2024-11-20 06:01:09,1858332,43112,664,193124,14448,989048,363732,941296,317488,47752,46244,520908,347080,1257264,146756,552,1450072,22196984
2024-11-20 06:01:12,1858332,43104,664,193124,14448,989176,363732,941424,317488,47752,46244,520908,347080,1257400,146808,552,1450072,22197004
2024-11-20 06:01:14,1858332,43112,664,193124,14448,989480,363732,941728,317488,47752,46244,520908,347080,1257620,146776,552,1450072,22196888
2024-11-20 06:01:16,1858332,42716,664,193124,14448,989588,363732,941836,317488,47752,46244,520908,347080,1257832,146572,552,1450072,22196992
2024-11-20 06:01:19,1858332,42500,664,193124,14448,989996,363732,942244,317488,47752,46244,520908,347080,1258128,146756,552,1450072,22197100
2024-11-20 06:01:22,1858332,42968,664,193124,14448,989856,363732,942104,317488,47752,46244,520908,347080,1257976,146756,552,1450072,22197024
2024-11-20 06:01:24,1858332,42456,664,193124,14448,990476,363732,942724,317488,47752,46244,520908,347080,1258436,146776,552,1450072,22196888
2024-11-20 06:01:27,1858332,42132,664,193124,14448,990696,363736,942944,317492,47752,46244,520908,347100,1258844,146756,552,1450072,22197044
2024-11-20 06:01:29,1858332,41640,664,193124,14448,991024,363736,943272,317492,47752,46244,520908,347100,1259164,146808,552,1450072,22197028
2024-11-20 06:01:32,1858332,41428,664,193124,14448,991232,363736,943480,317492,47752,46244,520908,347100,1259340,146776,552,1450072,22197036
2024-11-20 06:01:35,1858332,40548,664,193124,14448,991540,363736,943788,317492,47752,46244,520908,347100,1259748,146572,552,1450072,22197052
2024-11-20 06:01:37,1858332,40492,664,193124,14448,991708,363736,943956,317492,47752,46244,520908,347100,1259912,146800,552,1450072,22197012
2024-11-20 06:01:40,1858332,40948,664,193124,14448,991808,363736,944056,317492,47752,46244,520908,347100,1259948,146756,552,1450072,22196844
2024-11-20 06:01:42,1858332,40652,664,193124,14448,991664,363736,943912,317492,47752,46244,520908,347100,1260004,146624,552,1450072,22196844
2024-11-20 06:01:45,1858332,40224,664,193156,14448,992236,363740,944484,317496,47752,46244,520908,347104,1260436,146576,552,1450072,22197076
2024-11-20 06:01:47,1858332,40148,664,193156,14448,992572,363772,944820,317496,47752,46276,520908,347104,1260584,146776,552,1450072,22197020
2024-11-20 06:01:50,1858332,40008,664,193156,14448,992432,363772,944680,317496,47752,46276,520908,347104,1260576,146772,552,1450072,22196864
2024-11-20 06:01:53,1858332,39920,664,193156,14448,992512,363772,944760,317496,47752,46276,520908,347104,1260844,146760,552,1450072,22196836
2024-11-20 06:01:55,1858332,39400,664,193156,14448,992888,363772,945136,317496,47752,46276,520908,347104,1261192,146812,552,1450072,22197008
2024-11-20 06:01:58,1858332,39776,664,193156,14448,992916,363772,945164,317496,47752,46276,520908,347104,1261228,146764,552,1450072,22197096
2024-11-20 06:02:00,1858332,39360,664,193156,14448,993308,363772,945556,317496,47752,46276,520908,347104,1261436,146600,552,1450072,22196960
2024-11-20 06:02:03,1858332,38808,664,193156,14448,993292,363772,945540,317496,47752,46276,520908,347108,1261480,146764,552,1450072,22196944
2024-11-20 06:02:05,1858332,38640,664,193156,14448,993652,363776,945900,317500,47752,46276,520908,347108,1261740,146764,552,1450072,22197168
2024-11-20 06:02:07,1858332,38376,664,193156,14448,993884,363776,946132,317500,47752,46276,520908,347120,1261956,146748,552,1450072,22197156
2024-11-20 06:02:09,1858332,37352,664,193156,14448,994360,363780,946608,317504,47752,46276,520908,347120,1262564,146764,552,1450072,22196940
2024-11-20 06:02:11,1858332,37276,664,193156,14448,994584,363784,946832,317508,47752,46276,520908,347124,1262800,146580,552,1450072,22196960
2024-11-20 06:02:13,1858332,42492,664,193156,14448,989488,363792,941736,317516,47752,46276,520908,347140,1257652,146584,552,1450072,22197068
2024-11-20 06:02:16,1858332,41908,664,193156,14448,990052,363792,942300,317516,47752,46276,520908,347140,1258144,146716,552,1450072,22197088
2024-11-20 06:02:18,1858332,41720,664,193156,14448,990164,363792,942412,317516,47752,46276,520908,347140,1258272,146584,552,1450072,22197008
2024-11-20 06:02:20,1858332,41960,664,193156,14448,990316,363792,942564,317516,47752,46276,520908,347140,1258408,146768,552,1450072,22197060
2024-11-20 06:02:23,1858332,41784,664,193156,14448,990276,363792,942524,317516,47752,46276,520908,347140,1258388,146768,552,1450072,22197072
2024-11-20 06:02:25,1858332,41848,664,193156,14448,990536,363792,942784,317516,47752,46276,520908,347140,1258648,146768,552,1450072,22197052
2024-11-20 06:02:27,1858332,41556,664,193156,14448,990444,363792,942692,317516,47752,46276,520908,347140,1258552,146788,552,1450072,22196896
2024-11-20 06:02:29,1858332,41508,664,193156,14448,990612,363792,942860,317516,47752,46276,520908,347140,1258700,146768,552,1450072,22196880
2024-11-20 06:02:31,1858332,41024,664,193156,14448,991096,363792,943344,317516,47752,46276,520908,347140,1259224,146768,552,1450072,22196880
2024-11-20 06:02:33,1858332,40884,664,193156,14448,990876,363792,943124,317516,47752,46276,520908,347140,1259044,146768,552,1450072,22196900
2024-11-20 06:02:36,1858332,40760,664,193156,14448,991160,363792,943408,317516,47752,46276,520908,347140,1259236,146768,552,1450072,22196836
2024-11-20 06:02:38,1858332,40316,664,193156,14448,991184,363792,943432,317516,47752,46276,520908,347140,1259492,146636,552,1450072,22196944
2024-11-20 06:02:40,1858332,40204,664,193156,14448,991584,363792,943832,317516,47752,46276,520908,347140,1259772,146768,552,1450072,22197040
2024-11-20 06:02:42,1858332,40552,664,193156,14448,991372,363792,943620,317516,47752,46276,520908,347140,1259772,146768,552,1450072,22197020
2024-11-20 06:02:45,1858332,40188,664,193156,14448,991912,363792,944160,317516,47752,46276,520908,347140,1260052,146768,552,1450072,22197028
2024-11-20 06:02:47,1858332,39980,664,193156,14448,991888,363792,944136,317516,47752,46276,520908,347140,1260052,146812,552,1450072,22196996
2024-11-20 06:02:49,1858332,39508,664,193156,14448,992240,363792,944488,317516,47752,46276,520908,347140,1260412,146768,552,1450072,22197008
2024-11-20 06:02:51,1858332,39488,664,193156,14448,992440,363796,944688,317520,47752,46276,520908,347144,1260532,146768,552,1450072,22197112
2024-11-20 06:02:53,1858332,39540,664,193156,14448,992444,363796,944692,317520,47752,46276,520908,347144,1260584,146768,552,1450072,22197000
2024-11-20 06:02:56,1858332,39036,664,193160,14444,993120,363796,945368,317520,47752,46276,520908,347156,1261468,146768,552,1450072,22197024
2024-11-20 06:02:58,1858332,38736,664,193156,14444,993328,363804,945576,317528,47752,46276,520908,347156,1261484,146768,552,1450072,22197048
2024-11-20 06:03:00,1858332,38148,664,193156,14444,993712,363804,945960,317528,47752,46276,520908,347156,1261856,146768,552,1450072,22197016
2024-11-20 06:03:02,1858332,38224,664,193156,14444,993824,363804,946072,317528,47752,46276,520908,347156,1262052,146820,552,1450072,22197008
2024-11-20 06:03:04,1858332,37864,664,193156,14444,993988,363804,946236,317528,47752,46276,520908,347156,1262180,146768,552,1450072,22197068
2024-11-20 06:03:07,1858332,37996,664,193156,14444,994148,363804,946396,317528,47752,46276,520908,347296,1262260,146768,552,1450072,22197004
2024-11-20 06:03:09,1858332,38048,664,193156,14444,994056,363808,946304,317532,47752,46276,520908,347296,1262292,146768,552,1450072,22197000
2024-11-20 06:03:11,1858332,37988,664,193156,14444,994264,363808,946512,317532,47752,46276,520908,347296,1262456,146768,552,1450072,22197044
2024-11-20 06:03:13,1858332,38020,664,193156,14444,994328,363808,946576,317532,47752,46276,520908,347296,1262504,146768,552,1450072,22197040
2024-11-20 06:03:15,1858332,38124,664,193156,14444,994556,363808,946804,317532,47752,46276,520908,347300,1262832,146768,552,1450072,22196868
2024-11-20 06:03:18,1858332,37872,664,193156,14444,994856,363808,947104,317532,47752,46276,520908,347300,1263200,146768,552,1450072,22188956
2024-11-20 06:03:20,1858332,37348,664,193156,14444,994972,363808,947220,317532,47752,46276,520908,347300,1263216,146768,552,1450072,22197036
2024-11-20 06:03:23,1858332,37280,664,193156,14444,995232,363808,947480,317532,47752,46276,520908,347300,1263388,146788,552,1450072,22196868
2024-11-20 06:03:26,1858332,36632,664,193156,14444,995480,363808,947728,317532,47752,46276,520908,347300,1263448,146768,552,1450072,22197060
2024-11-20 06:03:28,1858332,36936,664,193164,14436,995444,363808,947692,317532,47752,46276,520908,347320,1263512,146820,552,1450072,22197040
2024-11-20 06:03:31,1858332,39448,700,201192,14532,990840,370760,942972,316544,47868,54216,520908,347484,1257808,140968,552,1450072,20276180
2024-11-20 06:03:34,1858332,38772,700,201192,14532,991348,370784,943480,316552,47868,54232,520908,347492,1258276,140784,552,1450072,20275988
2024-11-20 06:03:36,1858332,45600,708,201192,14532,984448,370792,936580,316552,47868,54240,520908,347492,1251360,140812,552,1450072,20276124
2024-11-20 06:03:39,1858332,45200,724,201196,14540,985164,370816,937296,316560,47868,54256,520908,347492,1251988,140628,552,1450072,20276180
2024-11-20 06:03:42,1858332,46404,724,201196,14540,983844,370820,935976,316560,47868,54260,520908,347492,1250956,140812,552,1450072,20276172
2024-11-20 06:03:44,1858332,46204,724,201196,14540,984144,370820,936276,316560,47868,54260,520908,347492,1250996,140856,552,1450072,20276096
2024-11-20 06:03:47,1858332,46636,732,201188,14540,984152,370824,936284,316564,47868,54260,520908,347524,1251108,140812,552,1450072,20276028
2024-11-20 06:03:50,1858332,46424,732,201204,14544,984332,370892,936460,316620,47872,54272,520908,347548,1251212,140820,552,1450072,20276172
2024-11-20 06:03:52,1858332,46092,740,201204,14544,984724,370900,936852,316620,47872,54280,520908,347548,1251708,140844,552,1450072,20276112
2024-11-20 06:03:55,1858332,45508,740,201204,14544,984864,370896,936992,316616,47872,54280,520908,347548,1251720,140636,552,1450072,20276176
2024-11-20 06:03:57,1858332,45484,744,201200,14544,985140,370904,937268,316624,47872,54280,520908,347556,1252248,140856,552,1450072,20276212
2024-11-20 06:04:00,1858332,45200,744,201204,14544,985304,370908,937432,316624,47872,54284,520908,347556,1252284,140820,552,1450072,20276012
2024-11-20 06:04:02,1858332,44992,744,201204,14544,985236,370912,937364,316628,47872,54284,520908,347560,1252216,140820,552,1450072,20276024
2024-11-20 06:04:05,1858332,45136,744,201204,14544,985312,370912,937440,316628,47872,54284,520908,347560,1252316,140824,552,1450072,20276076
2024-11-20 06:04:07,1858332,45004,744,201204,14544,985316,370912,937444,316628,47872,54284,520908,347560,1252300,140824,552,1450072,20276180
2024-11-20 06:04:09,1858332,44684,744,201204,14544,985544,370912,937672,316628,47872,54284,520908,347560,1252600,140644,552,1450072,20276116
2024-11-20 06:04:12,1858332,44480,744,201204,14544,986176,370912,938304,316628,47872,54284,520908,347560,1253032,140876,552,1450072,20267900
2024-11-20 06:04:15,1858332,43944,744,201204,14544,986284,370912,938412,316628,47872,54284,520908,347560,1253292,140828,552,1450072,20276088
2024-11-20 06:04:17,1858332,43740,744,201204,14544,986616,370912,938744,316628,47872,54284,520908,347560,1253684,140824,552,1450072,20276200
2024-11-20 06:04:20,1858332,43580,744,201204,14544,987480,370912,939608,316628,47872,54284,520908,347560,1254392,140828,552,1450072,20276080
2024-11-20 06:04:23,1858332,43236,744,201204,14580,987532,370964,939660,316680,47872,54284,520908,347576,1254644,140832,552,1450072,20276024
2024-11-20 06:04:25,1858332,42848,744,201204,14580,987684,370964,939812,316680,47872,54284,520908,347576,1254676,140956,552,1450072,20276052
2024-11-20 06:04:28,1858332,42584,744,201204,14580,987940,370964,940068,316680,47872,54284,520908,347576,1255052,140828,552,1450072,20276128
2024-11-20 06:04:30,1858332,42716,744,201204,14580,987888,370964,940016,316680,47872,54284,520908,347576,1255076,140856,552,1450072,20276100
2024-11-20 06:04:33,1858332,42140,744,201204,14580,988360,370964,940488,316680,47872,54284,520908,347576,1255140,140828,552,1450072,20276096
2024-11-20 06:04:35,1858332,42148,744,201204,14580,988756,370964,940884,316680,47872,54284,520908,347576,1255764,140696,552,1450072,20275940
2024-11-20 06:04:38,1858332,42116,744,201204,14580,988888,370964,941016,316680,47872,54284,520908,347576,1255900,140824,552,1450072,20276108
2024-11-20 06:04:40,1858332,41720,744,201204,14580,989036,370964,941164,316680,47872,54284,520908,347576,1255932,140828,552,1450072,20275952
2024-11-20 06:04:43,1858332,41880,744,201204,14580,989176,370964,941304,316680,47872,54284,520908,347576,1256220,140852,552,1450072,20275920
2024-11-20 06:04:46,1858332,41604,744,201204,14580,989180,370964,941308,316680,47872,54284,520908,347576,1256124,140840,552,1450072,20275836
2024-11-20 06:04:48,1858332,40560,744,201204,14580,990016,370964,942144,316680,47872,54284,520908,347576,1257288,140828,552,1450072,20276008
2024-11-20 06:04:51,1858332,46600,744,201204,14580,983772,370964,935900,316680,47872,54284,520908,347576,1250716,140828,552,1450072,20275912
2024-11-20 06:04:53,1858332,45856,744,201204,14580,984548,370964,936676,316680,47872,54284,520908,347576,1251528,140644,552,1450072,20276064
2024-11-20 06:04:56,1858332,45848,744,201204,14580,984436,370964,936564,316680,47872,54284,520908,347576,1251516,140828,552,1450072,20276068
2024-11-20 06:04:58,1858332,45680,744,201204,14580,984840,370964,936968,316680,47872,54284,520908,347580,1252036,140848,552,1450072,20276152
2024-11-20 06:05:01,1858332,45400,744,201204,14580,985032,370964,937160,316680,47872,54284,520908,347580,1252144,140828,552,1450072,20276072
2024-11-20 06:05:03,1858332,44824,744,201204,14580,985664,370964,937792,316680,47872,54284,520908,347580,1252552,140880,552,1450072,20275988
2024-11-20 06:05:06,1858332,44748,744,201204,14580,985856,370964,937984,316680,47872,54284,520908,347580,1252876,140772,552,1450072,20275936
2024-11-20 06:05:08,1858332,44804,744,201204,14580,985860,370968,937988,316684,47872,54284,520908,347584,1252976,140828,552,1450072,20275924
2024-11-20 06:05:11,1858332,44880,744,201204,14580,985952,370968,938080,316684,47872,54284,520908,347584,1252940,140828,552,1450072,20276016
2024-11-20 06:05:13,1858332,44740,744,201204,14580,985956,370968,938084,316684,47872,54284,520908,347584,1253016,140828,552,1450072,20275904
2024-11-20 06:05:16,1858332,44792,744,201204,14580,985856,370968,937984,316684,47872,54284,520908,347584,1253088,140828,552,1450072,20276204
2024-11-20 06:05:18,1858332,44228,744,201204,14580,986376,370968,938504,316684,47872,54284,520908,347584,1253376,140828,552,1450072,20275988
2024-11-20 06:05:21,1858332,43608,744,201204,14580,987048,370968,939176,316684,47872,54284,520908,347584,1254020,140828,552,1450072,20276000
2024-11-20 06:05:23,1858332,43524,744,201204,14580,986984,370968,939112,316684,47872,54284,520908,347584,1253868,140956,552,1450072,20276092
2024-11-20 06:05:26,1858332,43568,744,201204,14580,987272,370968,939400,316684,47872,54284,520908,347584,1254424,140828,552,1450072,20276080
2024-11-20 06:05:28,1858332,42956,744,201204,14580,987852,370968,939980,316684,47872,54284,520908,347584,1254704,140888,552,1450072,20276088
2024-11-20 06:05:30,1858332,42708,744,201204,14580,987876,370968,940004,316684,47872,54284,520908,347584,1254976,140828,552,1450072,20276204
2024-11-20 06:05:33,1858332,42608,744,201204,14580,988248,370964,940376,316680,47872,54284,520908,347584,1255196,140844,552,1450072,20276020
2024-11-20 06:05:35,1858332,42524,744,201204,14580,988040,370964,940168,316680,47872,54284,520908,347584,1255076,140828,552,1450072,20276100
2024-11-20 06:05:38,1858332,42088,744,201204,14580,988440,370964,940568,316680,47872,54284,520908,347584,1255612,140808,552,1450072,20275960
2024-11-20 06:05:41,1858332,42192,744,201204,14580,988472,370964,940600,316680,47872,54284,520908,347592,1255416,140828,552,1450072,20275996
2024-11-20 06:05:43,1858332,41744,744,201204,14580,988944,370964,941072,316680,47872,54284,520908,347592,1256092,140848,552,1450072,20276076
2024-11-20 06:05:46,1858332,41120,744,201204,14580,989280,370964,941408,316680,47872,54284,520908,347592,1256128,140732,552,1450072,20276044
2024-11-20 06:05:48,1858332,41324,744,201204,14580,989116,370964,941244,316680,47872,54284,520908,347592,1256364,140828,552,1450072,20275988
2024-11-20 06:05:51,1858332,41196,744,201204,14580,989144,370964,941272,316680,47872,54284,520908,347592,1256376,140828,552,1450072,20275876
2024-11-20 06:05:54,1858332,40904,744,201204,14580,989400,370964,941528,316680,47872,54284,520908,347592,1256476,140828,552,1450072,20276072
2024-11-20 06:05:56,1858332,40876,744,201204,14580,989500,370964,941628,316680,47872,54284,520908,347592,1256576,140692,552,1450072,20276052
2024-11-20 06:05:59,1858332,40444,744,201204,14580,990108,370964,942236,316680,47872,54284,520908,347592,1257244,140776,552,1450072,20276104
2024-11-20 06:06:02,1858332,40056,744,201204,14580,990476,370964,942604,316680,47872,54284,520908,347592,1257384,140648,552,1450072,20276196
2024-11-20 06:06:04,1858332,40040,744,201204,14580,990540,370964,942668,316680,47872,54284,520908,347592,1257624,140832,552,1450072,20275992
2024-11-20 06:06:07,1858332,45856,744,201204,14580,984384,370968,936512,316684,47872,54284,520908,347596,1251420,140832,552,1450072,20275976
2024-11-20 06:06:09,1858332,45868,744,201204,14580,984440,370968,936568,316684,47872,54284,520908,347596,1251648,140884,552,1450072,20276148
2024-11-20 06:06:12,1858332,45972,744,201204,14580,984604,370968,936732,316684,47872,54284,520908,347596,1251588,140832,552,1450072,20276024
2024-11-20 06:06:14,1858332,45268,744,201204,14580,985240,370968,937368,316684,47872,54284,520908,347596,1252332,140876,552,1450072,20275932
2024-11-20 06:06:17,1858332,45084,744,201204,14580,985280,370968,937408,316684,47872,54284,520908,347596,1252304,140776,552,1450072,20276128
2024-11-20 06:06:19,1858332,45132,744,201204,14580,985220,370968,937348,316684,47872,54284,520908,347596,1252384,140832,552,1450072,20276176
2024-11-20 06:06:22,1858332,44628,744,201204,14580,985276,370968,937404,316684,47872,54284,520908,347596,1252476,140648,552,1450072,20275984
2024-11-20 06:06:24,1858332,44932,744,201204,14580,985720,370968,937848,316684,47872,54284,520908,347596,1252676,140832,552,1450072,20276072
2024-11-20 06:06:27,1858332,44664,744,201204,14580,985736,370968,937864,316684,47872,54284,520908,347596,1252860,140832,552,1450072,20276136
2024-11-20 06:06:30,1858332,44488,744,201204,14580,985752,370968,937880,316684,47872,54284,520908,347596,1252704,140832,552,1450072,20276080
2024-11-20 06:06:32,1858332,43884,744,201204,14580,986244,370968,938372,316684,47872,54284,520908,347596,1253268,140872,552,1450072,20276056
2024-11-20 06:06:35,1858332,43868,744,201204,14580,986272,370968,938400,316684,47872,54284,520908,347596,1253200,140976,552,1450072,20275964
2024-11-20 06:06:37,1858332,43980,744,201204,14580,986544,370968,938672,316684,47872,54284,520908,347596,1253664,140832,552,1450072,20276020
2024-11-20 06:06:40,1858332,43604,744,201204,14580,986896,370968,939024,316684,47872,54284,520908,347596,1253900,140776,552,1450072,20275984
2024-11-20 06:06:43,1858332,43332,744,201204,14580,986836,370968,938964,316684,47872,54284,520908,347596,1253940,140832,552,1450072,20276064
2024-11-20 06:06:45,1858332,42936,744,201204,14580,987028,370968,939156,316684,47872,54284,520908,347596,1254408,140696,552,1450072,20275924
2024-11-20 06:06:48,1858332,42908,744,201204,14580,987316,370968,939444,316684,47872,54284,520908,347596,1254292,140856,552,1450072,20275968
2024-11-20 06:06:51,1858332,42720,744,201204,14580,987460,370968,939588,316684,47872,54284,520908,347596,1254692,140648,552,1450072,20275984
2024-11-20 06:06:53,1858332,42360,744,201204,14580,988064,370972,940192,316688,47872,54284,520908,347600,1254932,140884,552,1450072,20276048
2024-11-20 06:06:56,1858332,42460,744,201204,14580,988552,370680,940416,316660,48136,54020,520908,347620,1255232,140716,552,1450072,20275952
2024-11-20 06:06:58,1858332,42392,744,201204,14580,988628,370680,940492,316660,48136,54020,520908,347620,1255424,140832,552,1450072,20276112
2024-11-20 06:07:01,1858332,42148,744,201204,14580,988776,370680,940640,316660,48136,54020,520908,347620,1255472,140832,552,1450072,20275972
2024-11-20 06:07:04,1858332,38076,744,201204,14580,992192,370696,944056,316676,48136,54020,520908,347636,1259148,144452,552,1450072,22197608
2024-11-20 06:07:06,1858332,32952,752,199748,14580,999032,368932,950816,316440,48216,52492,520908,347796,1265664,149332,552,1450072,24118040
2024-11-20 06:07:09,1858332,32896,760,193932,14580,1004708,366220,957276,318752,47432,47468,520908,347796,1274684,151060,552,1450072,24119184
2024-11-20 06:07:11,1858332,42980,760,189484,14580,987164,362232,941260,317688,45904,44544,520908,347704,1257052,140400,556,1450072,20276092
2024-11-20 06:07:14,1858332,38684,768,189472,14580,991812,361732,945400,317696,46412,44036,520908,347720,1261408,143744,552,1450072,22197416
2024-11-20 06:07:17,1858332,38968,768,189480,14580,990820,361656,944220,317800,46600,43856,520908,347820,1260520,148036,552,1450072,24117876
2024-11-20 06:07:19,1858332,43976,776,188344,14576,990624,359424,943380,317340,47244,42084,520908,347796,1259236,146624,552,1450072,22197208
2024-11-20 06:07:22,1858332,43520,784,188348,14576,991516,359436,944268,317344,47248,42092,520908,347800,1259928,146880,552,1450072,22197192
2024-11-20 06:07:25,1858332,37768,792,188344,14580,995976,359584,948720,317492,47256,42092,520908,347956,1264604,149228,552,1450072,24118744
2024-11-20 06:07:27,1858332,32688,792,188348,14580,1001012,359588,953756,317496,47256,42092,520908,347956,1269724,151020,552,1450072,24119068
2024-11-20 06:07:30,1858332,50244,800,186268,14580,982652,358892,936428,317840,46224,41052,520908,347952,1252596,140336,552,1450072,20276144
2024-11-20 06:07:33,1858332,50200,800,186268,14580,983104,358892,936880,317840,46224,41052,520908,347952,1252864,140392,552,1450072,20276004
2024-11-20 06:07:35,1858332,47652,812,188572,14588,983380,361372,937144,318016,46236,43356,520908,348120,1253496,140560,552,1450072,20276064
2024-11-20 06:07:38,1858332,47060,812,188572,14588,984016,361372,937780,318016,46236,43356,520908,348120,1254108,140508,552,1450072,20275848
2024-11-20 06:07:40,1858332,46660,820,188572,14588,984308,361376,938072,318016,46236,43360,520908,348120,1254528,140508,552,1450072,20275956
2024-11-20 06:07:43,1858332,46468,820,188572,14588,984660,361380,938424,318016,46236,43364,520908,348120,1254572,140448,552,1450072,20276092
2024-11-20 06:07:46,1858332,45060,820,188572,14588,985648,361380,939412,318016,46236,43364,520908,348124,1255888,140876,552,1450072,22195844
2024-11-20 06:07:49,1858332,38088,828,188572,14592,991776,361616,945528,318256,46248,43360,520908,348360,1262072,144912,552,1450072,24117512
2024-11-20 06:07:51,1858332,40116,836,188148,14592,994084,358792,946164,317520,47920,41272,520908,348360,1262160,146760,552,1450072,22197220
2024-11-20 06:07:54,1858332,38608,844,188152,14592,995912,358644,947828,317532,48084,41112,520908,348428,1263620,147048,552,1450072,22197088
2024-11-20 06:07:57,1858332,38364,844,188152,14592,996044,358652,947960,317532,48084,41120,520908,348428,1263888,146876,552,1450072,22197240
2024-11-20 06:07:59,1858332,38316,852,188152,14592,996120,358660,948036,317532,48084,41128,520908,348428,1263884,146996,552,1450072,22197172
2024-11-20 06:08:02,1858332,38288,852,188152,14592,996268,358664,948184,317536,48084,41128,520908,348432,1263996,147056,552,1450072,22197080
2024-11-20 06:08:04,1858332,38076,852,188152,14592,996888,358672,948804,317544,48084,41128,520908,348440,1264696,146996,552,1450072,22197064
2024-11-20 06:08:07,1858332,37728,852,188152,14592,996964,358672,948880,317544,48084,41128,520908,348444,1264632,147056,552,1450072,22197280
2024-11-20 06:08:09,1858332,37008,852,188152,14596,997976,358692,949892,317564,48084,41128,520908,348812,1265844,146872,552,1450072,22197232
2024-11-20 06:08:11,1858332,43700,852,188152,14592,991204,358692,943120,317564,48084,41128,520908,349012,1259224,146320,552,1450072,22197168
2024-11-20 06:08:14,1858332,43440,852,188152,14592,991868,358696,943784,317568,48084,41128,520908,349012,1259832,146120,552,1450072,22197176
2024-11-20 06:08:16,1858332,42776,852,188152,14592,991828,358696,943744,317568,48084,41128,520908,349012,1259648,146144,552,1450072,22197336
2024-11-20 06:08:19,1858332,43156,852,188152,14592,992068,358696,943984,317568,48084,41128,520908,349012,1259964,146320,552,1450072,22197028
2024-11-20 06:08:22,1858332,42876,852,188152,14592,992188,358696,944104,317568,48084,41128,520908,349012,1260264,146304,552,1450072,22197036
2024-11-20 06:08:24,1858332,42984,852,188152,14592,992452,358696,944368,317568,48084,41128,520908,349012,1260344,146224,552,1450072,22197092
2024-11-20 06:08:26,1858332,42312,852,188152,14592,992632,358696,944548,317568,48084,41128,520908,349012,1260508,146304,552,1450072,22197180
2024-11-20 06:08:29,1858332,42028,852,188152,14592,993084,358696,945000,317568,48084,41128,520908,349012,1260972,146332,552,1450072,22197128
2024-11-20 06:08:32,1858332,41768,852,188152,14592,993152,358696,945068,317568,48084,41128,520908,349012,1261044,146312,552,1450072,22197092
2024-11-20 06:08:34,1858332,41456,852,188152,14592,993280,358696,945196,317568,48084,41128,520908,349012,1261024,146328,552,1450072,22197260
2024-11-20 06:08:37,1858332,41596,852,188152,14592,993504,358696,945420,317568,48084,41128,520908,349012,1261276,146312,552,1450072,22197092
2024-11-20 06:08:39,1858332,41392,852,188152,14592,993592,358696,945508,317568,48084,41128,520908,349012,1261404,146312,552,1450072,22197064
2024-11-20 06:08:42,1858332,41276,852,188152,14592,993476,358696,945392,317568,48084,41128,520908,349012,1261676,146312,552,1450072,22197132
2024-11-20 06:08:44,1858332,40968,852,188152,14592,993832,358696,945748,317568,48084,41128,520908,349012,1261724,146328,552,1450072,22197212
2024-11-20 06:08:47,1858332,40456,852,188152,14592,994232,358696,946148,317568,48084,41128,520908,349012,1262212,146312,552,1450072,22197084
2024-11-20 06:08:49,1858332,40612,852,188152,14592,994340,358696,946256,317568,48084,41128,520908,349012,1262160,146224,552,1450072,22197124
2024-11-20 06:08:52,1858332,40820,852,188152,14592,994212,358696,946128,317568,48084,41128,520908,349012,1262332,146312,552,1450072,22197180
2024-11-20 06:08:54,1858332,40432,852,188152,14592,994508,358696,946424,317568,48084,41128,520908,349012,1262260,146312,552,1450072,22197056
2024-11-20 06:08:57,1858332,36716,852,188152,14592,997976,358620,949816,317568,48160,41052,520908,349020,1265808,148368,552,1450072,24118188
2024-11-20 06:08:59,1858332,41876,860,187140,14592,994560,358884,947256,317980,47304,40904,520908,349272,1263588,147172,552,1450072,22197028
2024-11-20 06:09:02,1858332,41776,860,187140,14592,994680,358884,947376,317980,47304,40904,520908,349272,1263784,147064,552,1450072,22197020
2024-11-20 06:09:04,1858332,41576,868,187140,14592,995404,358892,948100,317980,47304,40912,520908,349272,1264664,147064,552,1450072,22196908
2024-11-20 06:09:07,1858332,41812,868,187140,14592,995284,358892,947980,317980,47304,40912,520908,349280,1264288,147004,552,1450072,22197092
2024-11-20 06:09:09,1858332,41484,868,187140,14592,995280,358892,947976,317980,47304,40912,520908,349280,1264220,147064,552,1450072,22197044
2024-11-20 06:09:12,1858332,41028,868,187140,14592,995388,358892,948084,317980,47304,40912,520908,349280,1264492,147064,552,1450072,22196996
2024-11-20 06:09:14,1858332,41484,868,187140,14592,995432,358892,948128,317980,47304,40912,520908,349280,1264532,146908,552,1450072,22196916
2024-11-20 06:09:17,1858332,41032,868,187140,14592,995680,358892,948376,317980,47304,40912,520908,349280,1264708,147064,552,1450072,22197100
2024-11-20 06:09:19,1858332,41000,868,187140,14592,995796,358892,948492,317980,47304,40912,520908,349280,1264724,146896,552,1450072,22196968
2024-11-20 06:09:22,1858332,40872,868,187140,14592,996440,358892,949136,317980,47304,40912,520908,349300,1265500,147084,552,1450072,22197016
2024-11-20 06:09:25,1858332,40336,868,187140,14592,996708,358892,949404,317980,47304,40912,520908,349300,1265708,147064,552,1450072,22196940
2024-11-20 06:09:27,1858332,40272,868,187140,14568,996840,358896,949536,317984,47304,40912,520908,349328,1265852,147100,552,1450072,22196956
2024-11-20 06:09:30,1858332,39804,868,187140,14568,997136,358896,949832,317984,47304,40912,520908,349328,1266100,147064,552,1450072,22188828
2024-11-20 06:09:33,1858332,39180,868,187140,14564,997840,358896,950536,317984,47304,40912,520908,349332,1266932,146880,552,1450072,22197160
2024-11-20 06:09:35,1858332,46760,868,187140,14564,990320,358620,943016,317708,47304,40912,520908,349492,1259176,146332,552,1450072,22196976
2024-11-20 06:09:38,1858332,46904,868,187140,14564,990472,358620,943168,317708,47304,40912,520908,349492,1259240,146312,552,1450072,22197068
2024-11-20 06:09:40,1858332,46932,868,187140,14564,990260,358620,942956,317708,47304,40912,520908,349492,1259000,146172,552,1450072,22197044
2024-11-20 06:09:43,1858332,46700,868,187140,14564,990660,358620,943356,317708,47304,40912,520908,349492,1259424,146312,552,1450072,22196992
2024-11-20 06:09:45,1858332,46924,868,187140,14564,990804,358620,943500,317708,47304,40912,520908,349492,1259528,146312,552,1450072,22196884
2024-11-20 06:09:48,1858332,46632,868,187140,14564,991584,358620,944280,317708,47304,40912,520908,349492,1260296,146256,552,1450072,22197104
2024-11-20 06:09:51,1858332,46132,868,187140,14564,991592,358620,944288,317708,47304,40912,520908,349492,1260508,146312,552,1450072,22196928
2024-11-20 06:09:53,1858332,46088,868,187140,14564,991784,358620,944480,317708,47304,40912,520908,349492,1260480,146356,552,1450072,22196856
2024-11-20 06:09:56,1858332,45656,868,187140,14564,991924,358620,944620,317708,47304,40912,520908,349492,1260964,146316,552,1450072,22196868
2024-11-20 06:09:58,1858332,45060,868,187140,14564,992140,358620,944836,317708,47304,40912,520908,349492,1260996,146324,552,1450072,22196960
2024-11-20 06:10:01,1858332,45444,864,197376,14708,988984,366380,941012,315948,47972,50432,520908,349628,1255348,139108,552,1450072,20275908
2024-11-20 06:10:03,1858332,44864,940,197452,14708,989400,366532,941392,315948,48008,50584,520908,349628,1255596,138936,552,1450072,20276112
2024-11-20 06:10:06,1858332,44152,940,197452,14708,990312,366540,942304,315948,48008,50592,520908,349628,1256308,139144,552,1450072,20276020
2024-11-20 06:10:09,1858332,47788,948,197444,14708,986188,366540,938180,315948,48008,50592,520908,349628,1252516,139120,552,1450072,20276240
2024-11-20 06:10:11,1858332,46824,948,197452,14708,986740,366548,938732,315948,48008,50600,520908,349628,1253096,138936,552,1450072,20276100
2024-11-20 06:10:14,1858332,46568,948,197452,14708,987260,366548,939252,315948,48008,50600,520908,349628,1253248,139120,552,1450072,20276248
2024-11-20 06:10:16,1858332,46744,948,197452,14708,987520,366552,939512,315952,48008,50600,520908,349632,1253720,138936,552,1450072,20276012
2024-11-20 06:10:19,1858332,45208,956,197460,14704,988848,366564,940836,315964,48012,50600,520908,349648,1254924,139120,552,1450072,20267904
2024-11-20 06:10:21,1858332,45064,956,197460,14704,989012,366572,940996,315964,48016,50608,520908,349648,1255256,139108,552,1450072,20275924
2024-11-20 06:10:24,1858332,45260,964,197452,14704,989076,366572,941060,315964,48016,50608,520908,349648,1255128,139120,552,1450072,20276004
2024-11-20 06:10:26,1858332,44576,964,197460,14704,989308,366584,941292,315968,48016,50616,520908,349652,1255452,139244,552,1450072,20275908
2024-11-20 06:10:29,1858332,44232,964,197460,14704,989440,366584,941424,315968,48016,50616,520908,349652,1255660,139120,552,1450072,20276004
2024-11-20 06:10:31,1858332,44140,964,197460,14704,989396,366584,941380,315968,48016,50616,520908,349652,1255712,139172,552,1450072,20276072
2024-11-20 06:10:34,1858332,44172,964,197460,14704,990252,366584,942236,315968,48016,50616,520908,349652,1256384,139132,552,1450072,20276004
2024-11-20 06:10:37,1858332,43908,964,197460,14704,990052,366584,942036,315968,48016,50616,520908,349652,1256276,138936,552,1450072,20276068
2024-11-20 06:10:39,1858332,43460,964,197460,14704,990468,366584,942452,315968,48016,50616,520908,349768,1256608,139164,552,1450072,20275892
2024-11-20 06:10:42,1858332,43404,964,197460,14704,990380,366584,942364,315968,48016,50616,520908,349768,1256628,138936,552,1450072,20275884
2024-11-20 06:10:44,1858332,43176,964,197460,14704,990740,366584,942724,315968,48016,50616,520908,349768,1256932,138980,552,1450072,20275856
2024-11-20 06:10:47,1858332,43032,964,197460,14704,990576,366584,942560,315968,48016,50616,520908,349768,1256768,139120,552,1450072,20276080
2024-11-20 06:10:49,1858332,42588,964,197460,14704,991228,366584,943212,315968,48016,50616,520908,349768,1257348,139120,552,1450072,20276040
2024-11-20 06:10:52,1858332,42692,964,197460,14704,991180,366584,943164,315968,48016,50616,520908,349768,1257476,139120,552,1450072,20275940
2024-11-20 06:10:55,1858332,42580,964,197460,14704,991468,366584,943452,315968,48016,50616,520908,349768,1257544,139120,552,1450072,20275912
2024-11-20 06:10:57,1858332,42504,964,197460,14704,991560,366584,943544,315968,48016,50616,520908,349768,1257636,139140,552,1450072,20276088
2024-11-20 06:11:00,1858332,42416,964,197460,14704,991768,366584,943752,315968,48016,50616,520908,349768,1257888,139144,552,1450072,20276060
2024-11-20 06:11:03,1858332,41996,964,197460,14704,992020,366584,944004,315968,48016,50616,520908,349768,1258288,139120,552,1450072,20276048
2024-11-20 06:11:05,1858332,41792,964,197460,14704,992212,366584,944196,315968,48016,50616,520908,349768,1258532,139028,552,1450072,20276192
2024-11-20 06:11:08,1858332,41700,964,197460,14704,992528,366584,944512,315968,48016,50616,520908,349768,1258756,139120,552,1450072,20276048
2024-11-20 06:11:11,1858332,41184,964,197460,14704,992836,366584,944820,315968,48016,50616,520908,349768,1259196,139172,552,1450072,20276012
2024-11-20 06:11:13,1858332,47568,964,197460,14704,986164,366584,938148,315968,48016,50616,520908,349768,1252168,139144,552,1450072,20276008
2024-11-20 06:11:16,1858332,47824,964,197460,14704,986304,366584,938288,315968,48016,50616,520908,349768,1252576,138936,552,1450072,20275916
2024-11-20 06:11:18,1858332,47740,964,197460,14704,986532,366584,938516,315968,48016,50616,520908,349768,1252736,139172,552,1450072,20276104
2024-11-20 06:11:21,1858332,47440,964,197460,14704,986748,366584,938732,315968,48016,50616,520908,349768,1253052,139120,552,1450072,20275976
2024-11-20 06:11:23,1858332,47100,964,197460,14704,987096,366584,939080,315968,48016,50616,520908,349768,1253388,139120,552,1450072,20275892
2024-11-20 06:11:26,1858332,47172,964,197460,14704,987016,366584,939000,315968,48016,50616,520908,349768,1253204,139120,552,1450072,20275972
2024-11-20 06:11:28,1858332,46632,964,197460,14704,987388,366584,939372,315968,48016,50616,520908,349768,1253548,138988,552,1450072,20275904
2024-11-20 06:11:31,1858332,46696,964,197460,14704,987436,366584,939420,315968,48016,50616,520908,349768,1253520,139120,552,1450072,20276100
2024-11-20 06:11:33,1858332,46616,964,197460,14704,987440,366584,939424,315968,48016,50616,520908,349768,1253488,138936,552,1450072,20276124
2024-11-20 06:11:36,1858332,46640,964,197460,14704,987580,366584,939564,315968,48016,50616,520908,349768,1253692,139164,552,1450072,20275988
2024-11-20 06:11:39,1858332,46568,964,197460,14704,987860,366584,939844,315968,48016,50616,520908,349768,1254080,139120,552,1450072,20276060
2024-11-20 06:11:41,1858332,46460,964,197460,14704,987996,366584,939980,315968,48016,50616,520908,349768,1253980,138956,552,1450072,20276180
2024-11-20 06:11:44,1858332,46128,964,197460,14704,988240,366584,940224,315968,48016,50616,520908,349768,1254460,138936,552,1450072,20276188
2024-11-20 06:11:46,1858332,45676,964,197460,14704,988312,366584,940296,315968,48016,50616,520908,349768,1254556,139120,552,1450072,20276132
2024-11-20 06:11:49,1858332,45504,964,197460,14704,988652,366584,940636,315968,48016,50616,520908,349768,1254976,139144,552,1450072,20276100
2024-11-20 06:11:52,1858332,45232,964,197460,14704,988824,366584,940808,315968,48016,50616,520908,349768,1254948,139304,552,1450072,20276032
2024-11-20 06:11:54,1858332,45128,964,197460,14704,988876,366584,940860,315968,48016,50616,520908,349768,1255012,139124,552,1450072,20276072
2024-11-20 06:11:57,1858332,44652,964,197460,14704,989196,366584,941180,315968,48016,50616,520908,349768,1255380,139120,552,1450072,20276028
2024-11-20 06:11:59,1858332,43928,964,197460,14704,989636,366600,941620,315984,48016,50616,520908,349784,1255756,139124,552,1450072,20276100
2024-11-20 06:12:02,1858332,43856,964,197980,14704,989596,367132,941580,315996,48016,51136,520908,349796,1255988,139156,552,1450072,20276068
2024-11-20 06:12:04,1858332,43460,964,197980,14704,989936,367132,941920,315996,48016,51136,520908,349796,1256100,139260,552,1450072,20276072
2024-11-20 06:12:07,1858332,43248,964,197980,14704,989980,367132,941964,315996,48016,51136,520908,349796,1256116,139156,552,1450072,20276172
2024-11-20 06:12:09,1858332,42888,964,197980,14704,990388,367132,942372,315996,48016,51136,520908,349796,1256616,139156,552,1450072,20275960
2024-11-20 06:12:12,1858332,42672,964,197980,14704,991032,367132,943016,315996,48016,51136,520908,349796,1257184,139164,552,1450072,20276140
2024-11-20 06:12:15,1858332,42128,964,197980,14704,991300,367132,943284,315996,48016,51136,520908,349796,1257432,139156,552,1450072,20276000
2024-11-20 06:12:17,1858332,42136,964,197980,14704,991272,367132,943256,315996,48016,51136,520908,349796,1257456,139176,552,1450072,20276236
2024-11-20 06:12:20,1858332,41420,964,197980,14704,992012,367132,943996,315996,48016,51136,520908,349796,1258264,139088,552,1450072,20276072
2024-11-20 06:12:22,1858332,41252,964,197980,14708,991972,367136,943956,316000,48016,51136,520908,349796,1258212,139156,552,1450072,20276064
2024-11-20 06:12:25,1858332,40492,964,197980,14708,992792,367144,944776,316008,48016,51136,520908,349804,1259176,139208,552,1450072,20276036
2024-11-20 06:12:28,1858332,46664,964,197980,14708,986156,367120,938140,315984,48016,51136,520908,349888,1252580,139156,552,1450072,20275952
2024-11-20 06:12:30,1858332,46688,964,197980,14704,986492,367120,938476,315984,48016,51136,520908,349892,1252784,139128,552,1450072,20276120
2024-11-20 06:12:32,1858332,44676,1060,206956,14720,987292,368752,938288,309640,49004,59112,520908,349932,1246192,136972,552,1450072,20145828
2024-11-20 06:12:35,1858332,44916,1060,206976,14720,987272,368708,938192,309600,49080,59108,520908,349932,1246076,136852,552,1450072,20145740
2024-11-20 06:12:37,1858332,44808,1060,206976,14720,987512,368708,938432,309600,49080,59108,520908,349932,1246308,136836,552,1450072,20145868
2024-11-20 06:12:39,1858332,44404,1060,206976,14720,987772,368712,938692,309604,49080,59108,520908,349936,1246576,136852,552,1450072,20145860
2024-11-20 06:12:41,1858332,44516,1060,206976,14720,987780,368716,938700,309608,49080,59108,520908,349948,1246456,136840,552,1450072,20145884
2024-11-20 06:12:43,1858332,44356,1060,206976,14720,987992,368780,938912,309616,49080,59164,520908,349948,1246752,136856,552,1450072,20145836
2024-11-20 06:12:45,1858332,44244,1060,206976,14720,988228,368780,939148,309616,49080,59164,520908,349948,1246924,136832,552,1450072,20145816
2024-11-20 06:12:47,1858332,44224,1060,206976,14720,988296,368780,939216,309616,49080,59164,520908,349948,1247064,136872,552,1450072,20145680
2024-11-20 06:12:49,1858332,43932,1060,206976,14720,988832,368780,939752,309616,49080,59164,520908,349948,1247608,136872,552,1450072,20145816
2024-11-20 06:12:51,1858332,43980,1060,206976,14720,989012,368780,939932,309616,49080,59164,520908,349948,1247648,136852,552,1450072,20145716
2024-11-20 06:12:54,1858332,43576,1060,206976,14720,989256,368780,940176,309616,49080,59164,520908,349948,1248068,136852,552,1450072,20145720
