Timestamp,MemTotal,MemFree,Buffers,Cached,SwapCached,Active,Inactive,Active(anon),Inactive(anon),Active(file),Inactive(file),SwapTotal,SwapFree,AnonPages,Mapped,Shmem,CommitLimit,Committed_AS
2024-11-20 02:26:22,1858332,117988,904,1185100,16568,324592,907632,79248,67148,245344,840484,520908,367088,144684,588160,824,1450072,26020488
2024-11-20 02:26:22,1858332,117988,904,1185100,16568,324592,907632,79248,67148,245344,840484,520908,367088,144684,588160,824,1450072,26020488
2024-11-20 02:26:22,1858332,117988,904,1185100,16568,324592,907632,79248,67148,245344,840484,520908,367088,144684,588160,824,1450072,26020488
2024-11-20 02:26:22,1858332,117988,904,1185100,16568,324592,907632,79248,67148,245344,840484,520908,367088,144684,588160,824,1450072,26020488
2024-11-20 02:26:22,1858332,117988,904,1185100,16568,324592,907632,79248,67148,245344,840484,520908,367088,144684,588160,824,1450072,26020488
2024-11-20 02:26:22,1858332,117988,904,1185100,16568,324592,907632,79248,67148,245344,840484,520908,367088,144684,588160,824,1450072,26020488
2024-11-20 02:26:22,1858332,117988,904,1185100,16568,324592,907632,79248,67148,245344,840484,520908,367088,144684,588160,824,1450072,26020488
2024-11-20 02:26:22,1858332,117988,904,1185100,16568,324592,907632,79248,67148,245344,840484,520908,367088,144684,588160,824,1450072,26020488
2024-11-20 02:26:22,1858332,117988,904,1185100,16568,324592,907632,79248,67148,245344,840484,520908,367088,144684,588160,824,1450072,26020488
2024-11-20 02:26:22,1858332,117988,904,1185100,16568,324592,907632,79248,67148,245344,840484,520908,367088,144684,588160,824,1450072,26020488
2024-11-20 02:26:22,1858332,117988,904,1185100,16568,324592,907632,79248,67148,245344,840484,520908,367088,144684,588160,824,1450072,26020488
2024-11-20 02:26:24,1858332,116124,516,1206744,16408,641484,612596,89644,57624,551840,554972,520908,366460,145492,916188,812,1450072,26117576
2024-11-20 02:26:27,1858332,115900,516,1205908,16408,642432,611084,89976,57244,552456,553840,520908,366464,145248,907336,812,1450072,26117444
2024-11-20 02:26:29,1858332,116076,504,1205476,16408,642716,610708,90616,57136,552100,553572,520908,366464,146096,904572,812,1450072,26117440
2024-11-20 02:26:31,1858332,116856,236,1203060,16404,642852,609060,91636,56996,551216,552064,520908,366476,146904,899908,812,1450072,26117396
2024-11-20 02:26:33,1858332,116300,248,1204128,16404,643336,609124,91968,56788,551368,552336,520908,366476,146980,895880,812,1450072,26117304
2024-11-20 02:26:35,1858332,115792,248,1204644,16404,643528,609864,92204,56672,551324,553192,520908,366476,147040,894188,812,1450072,26117412
2024-11-20 02:26:37,1858332,115272,288,1202104,16488,645852,607396,94864,56532,550988,550864,520908,368948,149748,889504,852,1450072,26117528
2024-11-20 02:26:40,1858332,115188,292,1202680,16488,646096,608252,95312,56408,550784,551844,520908,368948,149952,887580,852,1450072,26117412
2024-11-20 02:26:42,1858332,113920,300,1203716,16488,646212,609332,95676,56280,550536,553052,520908,368940,150268,884936,852,1450072,26117228
2024-11-20 02:26:44,1858332,96160,596,1200052,16488,667232,606104,116864,56036,550368,550068,520908,368936,171204,878036,852,1450072,26212292
2024-11-20 02:26:46,1858332,70180,596,1199556,16488,692576,606060,142708,56036,549868,550024,520908,368936,196848,878692,852,1450072,26237540
2024-11-20 02:26:48,1858332,33464,532,1039668,16484,769884,569920,300416,99692,469468,470228,520908,368704,398312,789952,852,1450072,27036480
2024-11-20 02:26:50,1858332,32208,128,493068,15440,907904,433768,711836,236996,196068,196772,520908,368172,948216,148992,852,1450072,27036404
2024-11-20 02:26:53,1858332,42992,120,184700,15344,1002428,350652,962708,306212,39720,44440,520908,367696,1268044,113428,848,1450072,20274028
2024-11-20 02:26:55,1858332,29988,408,200260,15044,997584,373340,952676,317700,44908,55640,520908,365564,1269212,128812,712,1450072,22195252
2024-11-20 02:26:58,1858332,36056,388,198852,14992,997096,370736,951040,317932,46056,52804,520908,363968,1267692,125384,712,1450072,20273988
2024-11-20 02:27:00,1858332,32972,388,200824,14992,997732,372844,951548,317832,46184,55012,520908,363968,1267880,125412,712,1450072,20274008
2024-11-20 02:27:02,1858332,38956,396,191672,14992,998972,364656,952440,319112,46532,45544,520908,363980,1269908,126992,712,1450072,24115364
2024-11-20 02:27:05,1858332,38100,480,194424,14996,998828,365960,951284,318612,47544,47348,520908,363952,1268404,125376,712,1450072,20274052
2024-11-20 02:27:07,1858332,32988,308,200236,14992,1000664,370100,952768,317748,47896,52352,520908,363560,1269064,128400,712,1450072,20274100
2024-11-20 02:27:10,1858332,41604,308,199100,14992,998072,365040,950064,313636,48008,51404,520908,363596,1262340,127656,712,1450072,20273808
2024-11-20 02:27:12,1858332,40932,308,199208,14992,998896,365164,950888,313608,48008,51556,520908,363604,1263044,127672,712,1450072,20273824
2024-11-20 02:27:15,1858332,42352,308,199208,14992,998108,364312,950100,312756,48008,51556,520908,363604,1261580,127864,712,1450072,20273848
2024-11-20 02:27:17,1858332,39724,308,201752,14992,998628,366728,950620,312664,48008,54064,520908,363644,1261924,128072,712,1450072,20273960
2024-11-20 02:27:20,1858332,37872,320,200324,15000,999160,366984,951120,314460,48040,52524,520908,363672,1264444,132024,712,1450072,22195360
2024-11-20 02:27:23,1858332,35776,280,195356,15020,1001340,366528,953988,318096,47352,48432,520908,363848,1270604,134952,712,1450072,24115568
2024-11-20 02:27:26,1858332,39648,404,200800,15144,992124,372432,944936,318624,47188,53808,520908,363224,1261812,130032,712,1450072,20273852
2024-11-20 02:27:28,1858332,39252,404,201624,15140,992484,373256,945192,318592,47292,54664,520908,363260,1262284,130432,712,1450072,20274720
2024-11-20 02:27:31,1858332,38940,412,201664,15140,992880,373364,945588,318540,47292,54824,520908,363264,1262480,130416,712,1450072,20274816
2024-11-20 02:27:33,1858332,38196,412,201784,15140,993040,373472,945748,318528,47292,54944,520908,363264,1262776,130296,712,1450072,20274580
2024-11-20 02:27:36,1858332,38824,416,200832,15136,993692,372128,946400,318124,47292,54004,520908,363264,1262880,130588,712,1450072,20274648
2024-11-20 02:27:39,1858332,39044,416,200832,15136,993564,372056,946272,318052,47292,54004,520908,363264,1262740,130504,712,1450072,20274780
2024-11-20 02:27:41,1858332,39008,416,200832,15136,993676,372044,946384,318040,47292,54004,520908,363264,1262684,130848,712,1450072,20274784
2024-11-20 02:27:44,1858332,38852,416,200832,15136,993736,372044,946444,318040,47292,54004,520908,363264,1262940,130688,712,1450072,20274824
2024-11-20 02:27:46,1858332,38764,416,200904,15136,994172,372112,946880,318036,47292,54076,520908,363268,1263252,130676,712,1450072,20274728
2024-11-20 02:27:49,1858332,37516,416,201200,15136,994920,372408,947628,318036,47292,54372,520908,363268,1264048,130708,712,1450072,20274732
2024-11-20 02:27:51,1858332,37372,416,201244,15140,995052,372452,947760,318036,47292,54416,520908,363268,1263980,130624,712,1450072,20274688
2024-11-20 02:27:54,1858332,36956,416,201484,15140,995236,372664,947944,318024,47292,54640,520908,363268,1264216,130720,712,1450072,20274784
2024-11-20 02:27:56,1858332,36940,416,201492,15132,995412,372660,948120,318004,47292,54656,520908,363460,1264460,130748,712,1450072,20274588
2024-11-20 02:27:59,1858332,36792,416,201492,15132,995716,372668,948424,318004,47292,54664,520908,363460,1264956,130752,712,1450072,20274620
2024-11-20 02:28:01,1858332,36376,416,201492,15132,995748,372672,948456,318008,47292,54664,520908,363464,1264988,130548,712,1450072,20274632
2024-11-20 02:28:04,1858332,36260,416,201492,15132,996060,372672,948768,318008,47292,54664,520908,363484,1265092,130684,712,1450072,20274800
2024-11-20 02:28:07,1858332,36356,416,201492,15132,996060,372672,948768,318008,47292,54664,520908,363488,1265404,130756,712,1450072,20274708
2024-11-20 02:28:09,1858332,36112,416,201524,15132,996440,372712,949148,318016,47292,54696,520908,363492,1265480,130924,712,1450072,20274664
2024-11-20 02:28:12,1858332,35792,416,201544,15132,996656,372712,949364,318016,47292,54696,520908,363492,1265428,130592,712,1450072,20274736
2024-11-20 02:28:14,1858332,38132,416,198396,15132,997076,369348,949780,317784,47296,51564,520908,363492,1265848,130812,712,1450072,20274700
2024-11-20 02:28:17,1858332,38000,416,198396,15132,997252,369348,949956,317784,47296,51564,520908,363492,1266084,130768,712,1450072,20274684
2024-11-20 02:28:19,1858332,37660,416,198512,15132,997252,369464,949956,317784,47296,51680,520908,363492,1266128,130836,712,1450072,20274692
2024-11-20 02:28:22,1858332,37828,416,198512,15132,997688,369460,950392,317780,47296,51680,520908,363492,1266420,130796,712,1450072,20274584
2024-11-20 02:28:24,1858332,37624,416,198512,15132,997520,369460,950224,317780,47296,51680,520908,363492,1266276,130792,712,1450072,20274596
2024-11-20 02:28:27,1858332,37212,416,198900,15132,997548,369836,950252,317804,47296,52032,520908,363516,1266420,130760,712,1450072,20274748
2024-11-20 02:28:29,1858332,34988,416,198708,15132,999992,369504,952692,317644,47300,51860,520908,363524,1268928,131908,712,1450072,22194436
2024-11-20 02:28:32,1858332,36180,384,191692,15124,1001892,365060,955464,319172,46428,45888,520908,363584,1270452,132216,712,1450072,24116360
2024-11-20 02:28:34,1858332,41520,384,198524,15124,991036,371460,944588,318952,46448,52508,520908,363636,1261836,130956,712,1450072,20274660
2024-11-20 02:28:37,1858332,42280,392,198524,15124,991064,371460,944616,318952,46448,52508,520908,363636,1262100,130956,712,1450072,20274576
2024-11-20 02:28:39,1858332,38400,312,202060,15124,992100,374336,945512,318588,46588,55748,520908,363636,1262384,131628,712,1450072,20274760
2024-11-20 02:28:42,1858332,38700,312,202284,15124,991240,374648,944652,318592,46588,56056,520908,363668,1261664,131168,712,1450072,20274632
2024-11-20 02:28:45,1858332,40676,312,200892,15128,991428,372612,944840,317944,46588,54668,520908,363780,1261004,131532,712,1450072,20291056
2024-11-20 02:28:47,1858332,40340,312,200928,15128,991832,372640,945244,317940,46588,54700,520908,363780,1261496,131564,712,1450072,20291080
2024-11-20 02:28:50,1858332,40196,312,200928,15128,992020,372612,945432,317912,46588,54700,520908,363804,1261792,131720,712,1450072,20290984
2024-11-20 02:28:52,1858332,40064,312,200928,15128,991792,372616,945204,317916,46588,54700,520908,363804,1261588,131536,712,1450072,20291252
2024-11-20 02:28:55,1858332,40048,312,200928,15132,992208,372620,945620,317920,46588,54700,520908,363832,1261824,131684,712,1450072,20291180
2024-11-20 02:28:57,1858332,39700,312,200928,15132,992636,372616,946048,317916,46588,54700,520908,363832,1262184,131728,712,1450072,20291076
2024-11-20 02:29:00,1858332,39492,312,200928,15132,992720,372596,946132,317896,46588,54700,520908,363832,1262416,131728,712,1450072,20291028
2024-11-20 02:29:02,1858332,39540,312,200928,15132,993012,372416,946424,317716,46588,54700,520908,363832,1262612,131632,712,1450072,20291012
2024-11-20 02:29:05,1858332,38672,312,200996,15228,994960,371288,947300,317592,47660,53696,520908,363988,1263216,131768,712,1450072,20291032
2024-11-20 02:29:08,1858332,39168,300,199956,15228,996180,369828,948416,317284,47764,52544,520908,363980,1264088,132168,712,1450072,20291020
2024-11-20 02:29:10,1858332,38756,300,200164,15228,996352,370036,948588,317288,47764,52748,520908,363980,1264256,132140,712,1450072,20291092
2024-11-20 02:29:13,1858332,37468,300,200832,15224,997180,370708,949416,317292,47764,53416,520908,363988,1265124,132736,712,1450072,20290928
2024-11-20 02:29:15,1858332,36800,300,200832,15224,997568,370704,949804,317288,47764,53416,520908,364012,1265404,132760,712,1450072,20291000
2024-11-20 02:29:17,1858332,36448,300,200832,15224,997516,370704,949752,317288,47764,53416,520908,364012,1265480,132736,712,1450072,20291208
2024-11-20 02:29:20,1858332,38772,296,197956,15224,998412,367460,950560,317012,47852,50448,520908,363980,1266064,132752,712,1450072,20291140
2024-11-20 02:29:23,1858332,37048,296,199428,15224,998484,368948,950632,317012,47852,51936,520908,363980,1266336,132920,712,1450072,20291140
2024-11-20 02:29:25,1858332,36916,296,199548,15224,999040,369052,951188,317012,47852,52040,520908,363980,1266520,132796,712,1450072,20291100
2024-11-20 02:29:28,1858332,36512,296,199548,15224,999212,369052,951360,317012,47852,52040,520908,364016,1266496,132956,712,1450072,20291172
2024-11-20 02:29:30,1858332,36412,296,199548,15224,999272,369052,951420,317012,47852,52040,520908,364020,1266768,132944,712,1450072,20290936
2024-11-20 02:29:33,1858332,35892,296,199548,15224,999616,369052,951764,317012,47852,52040,520908,364044,1267076,132956,712,1450072,20291180
2024-11-20 02:29:35,1858332,34412,296,196604,15224,1002908,367268,955056,318208,47852,49060,520908,364024,1271836,132900,712,1450072,20291228
2024-11-20 02:29:38,1858332,34260,276,193828,15196,1004224,366216,957200,319012,47024,47204,520908,364016,1274484,132956,712,1450072,20291088
2024-11-20 02:29:40,1858332,34592,276,193836,15196,1004084,366148,957060,319012,47024,47136,520908,364016,1274404,132896,712,1450072,20291016
2024-11-20 02:29:43,1858332,33868,276,193836,15196,1004484,366148,957460,319012,47024,47136,520908,364016,1274908,132840,712,1450072,20291088
2024-11-20 02:29:45,1858332,34196,276,193836,15196,1004476,366148,957452,319012,47024,47136,520908,364016,1274880,132776,712,1450072,20291076
2024-11-20 02:29:48,1858332,33248,276,193836,15196,1005296,366152,958272,319016,47024,47136,520908,364020,1275504,132776,712,1450072,20290996
2024-11-20 02:29:50,1858332,40428,276,193836,15196,998120,366152,951096,319016,47024,47136,520908,364020,1268388,132744,712,1450072,20291048
2024-11-20 02:29:53,1858332,40240,276,193836,15196,998256,366152,951232,319016,47024,47136,520908,364020,1268556,132960,712,1450072,20291208
2024-11-20 02:29:55,1858332,39872,276,193836,15196,998772,366152,951748,319016,47024,47136,520908,364024,1269304,132960,712,1450072,20291192
2024-11-20 02:29:58,1858332,39404,276,193876,15196,998988,366192,951964,319016,47024,47176,520908,364024,1269388,132968,712,1450072,20291184
2024-11-20 02:30:00,1858332,39796,276,193876,15196,998792,366192,951768,319016,47024,47176,520908,364024,1269184,132968,712,1450072,20291096
2024-11-20 02:30:03,1858332,39780,276,193876,15196,999244,366196,952220,319020,47024,47176,520908,364244,1269420,132968,712,1450072,20291160
2024-11-20 02:30:05,1858332,40040,276,193876,15196,998928,366196,951904,319020,47024,47176,520908,364244,1269312,133152,712,1450072,20291008
2024-11-20 02:30:08,1858332,39064,276,193976,15196,999556,366296,952532,319020,47024,47276,520908,364244,1269772,132872,712,1450072,20291092
2024-11-20 02:30:11,1858332,39024,276,193976,15196,999436,366296,952412,319020,47024,47276,520908,364244,1269480,132804,712,1450072,20291116
2024-11-20 02:30:13,1858332,38724,276,193976,15196,1000056,366296,953032,319020,47024,47276,520908,364244,1270428,132956,712,1450072,20291148
2024-11-20 02:30:16,1858332,38520,276,193976,15196,999928,366300,952904,319024,47024,47276,520908,364252,1270380,132988,712,1450072,20291200
2024-11-20 02:30:18,1858332,38640,276,193976,15196,1000100,366300,953076,319024,47024,47276,520908,364256,1270488,132860,712,1450072,20290980
2024-11-20 02:30:21,1858332,37876,276,193976,15196,1000364,366300,953340,319024,47024,47276,520908,364256,1270880,132988,712,1450072,20291092
2024-11-20 02:30:23,1858332,38528,276,193976,15196,1000476,365588,953452,318312,47024,47276,520908,364272,1270020,132804,712,1450072,20291076
2024-11-20 02:30:26,1858332,38696,276,193976,15196,1000680,365576,953656,318300,47024,47276,520908,364272,1270308,132804,712,1450072,20290940
2024-11-20 02:30:28,1858332,38060,276,193976,15196,1001028,365576,954004,318300,47024,47276,520908,364272,1270612,132988,712,1450072,20291116
2024-11-20 02:30:31,1858332,37784,276,193976,15196,1001016,365576,953992,318300,47024,47276,520908,364272,1270840,132804,712,1450072,20291060
2024-11-20 02:30:33,1858332,38108,276,193976,15196,1001256,365576,954232,318300,47024,47276,520908,364272,1270932,132804,712,1450072,20291156
2024-11-20 02:30:36,1858332,37780,276,193976,15196,1001504,365576,954480,318300,47024,47276,520908,364452,1271160,132988,712,1450072,20291036
2024-11-20 02:30:38,1858332,37552,276,193976,15196,1001476,365576,954452,318300,47024,47276,520908,364464,1271196,132960,712,1450072,20290996
2024-11-20 02:30:41,1858332,37860,276,193976,15196,1001320,365580,954296,318304,47024,47276,520908,364464,1270812,132804,712,1450072,20290952
2024-11-20 02:30:43,1858332,35352,256,193176,15220,1000564,368436,956952,318608,43612,49828,520908,364440,1274040,134728,712,1450072,20292936
2024-11-20 02:30:46,1858332,32324,264,193172,15220,1002640,368464,959024,318600,43616,49864,520908,364472,1276100,135688,712,1450072,22213020
2024-11-20 02:30:49,1858332,37540,356,186980,15052,1000616,365132,957808,320576,42808,44556,520908,364120,1276580,137496,712,1450072,22213500
2024-11-20 02:30:52,1858332,34696,364,188220,14940,1003000,365052,959660,319812,43340,45240,520908,363324,1277960,138840,704,1450072,22214404
2024-11-20 02:30:54,1858332,34104,372,189672,15152,1002404,367088,958848,320492,43556,46596,520908,362560,1277464,139980,696,1450072,22213532
2024-11-20 02:30:57,1858332,41232,392,186688,15264,999432,363028,955320,319996,44112,43032,520908,361748,1273620,135680,696,1450072,20292956
2024-11-20 02:30:59,1858332,37036,400,186688,15276,1003548,363088,959412,320064,44136,43024,520908,361812,1277648,139052,696,1450072,22214392
2024-11-20 02:31:02,1858332,38520,400,185968,15300,1002420,362476,958128,320336,44292,42140,520908,361036,1276696,137968,696,1450072,22213464
2024-11-20 02:31:05,1858332,44732,408,189528,15300,995376,363828,949248,319956,46128,43872,520908,360500,1267500,134844,696,1450072,20293020
2024-11-20 02:31:07,1858332,44352,408,189528,15300,995840,363788,949712,319916,46128,43872,520908,360512,1267696,134844,696,1450072,20293040
2024-11-20 02:31:10,1858332,41388,468,189680,15300,998580,363988,952428,319928,46152,44060,520908,360524,1270784,136328,696,1450072,22213240
2024-11-20 02:31:13,1858332,41252,468,189680,15300,998596,363988,952444,319928,46152,44060,520908,360524,1270864,136308,696,1450072,22213192
2024-11-20 02:31:15,1858332,41832,476,190212,15300,996880,364528,950728,319928,46152,44600,520908,360672,1268840,136340,696,1450072,22213296
2024-11-20 02:31:18,1858332,40532,476,191956,15300,997096,366016,950944,319672,46152,46344,520908,360672,1268996,136380,696,1450072,22213328
2024-11-20 02:31:21,1858332,36472,484,191952,15296,1000508,366080,954356,319728,46152,46352,520908,360740,1272324,138760,696,1450072,24134776
2024-11-20 02:31:24,1858332,39300,484,189472,15296,1000764,362856,954792,318808,45972,44048,520908,360208,1271832,140500,696,1450072,22213812
2024-11-20 02:31:26,1858332,42596,492,192124,15324,996544,364568,950164,318268,46380,46300,520908,359300,1266840,135560,696,1450072,20293008
2024-11-20 02:31:29,1858332,42576,492,192212,15324,996584,364624,950204,318268,46380,46356,520908,359300,1266664,135688,696,1450072,20293028
2024-11-20 02:31:32,1858332,42596,500,192412,15324,996828,364848,950448,318268,46380,46580,520908,359300,1266828,135704,696,1450072,20293068
2024-11-20 02:31:34,1858332,43484,500,192504,15324,997080,363548,950700,316860,46380,46688,520908,359300,1265636,135540,696,1450072,20293040
2024-11-20 02:31:37,1858332,43284,504,192628,15324,996892,363672,950512,316860,46380,46812,520908,359300,1265660,135536,696,1450072,20293092
2024-11-20 02:31:39,1858332,42552,504,193324,15324,997400,364352,951020,316864,46380,47488,520908,359304,1265940,135928,696,1450072,20293008
2024-11-20 02:31:42,1858332,42252,504,193324,15324,997456,364376,951076,316864,46380,47512,520908,359304,1266220,135784,696,1450072,20292908
2024-11-20 02:31:44,1858332,41872,504,193324,15324,997676,364368,951296,316856,46380,47512,520908,359304,1266348,135612,696,1450072,20293012
2024-11-20 02:31:47,1858332,39448,504,195136,15324,998372,366156,951992,316856,46380,49300,520908,359304,1266988,135680,696,1450072,20292952
2024-11-20 02:31:50,1858332,39492,504,195136,15324,998284,366180,951904,316856,46380,49324,520908,359304,1266952,135620,696,1450072,20292996
2024-11-20 02:31:52,1858332,38344,504,195140,15324,999816,366196,953436,316868,46380,49328,520908,359316,1268540,135684,696,1450072,20292964
2024-11-20 02:31:54,1858332,38324,504,195140,15324,999932,366196,953552,316868,46380,49328,520908,359316,1268468,135828,696,1450072,20292996
2024-11-20 02:31:57,1858332,37944,504,195140,15324,1000164,366196,953784,316868,46380,49328,520908,359316,1269004,135848,696,1450072,20292892
2024-11-20 02:31:59,1858332,37852,504,195140,15324,1000304,366196,953924,316868,46380,49328,520908,359316,1269012,135828,696,1450072,20292884
2024-11-20 02:32:02,1858332,37352,504,195140,15324,1000708,366168,954328,316840,46380,49328,520908,359316,1269392,135764,696,1450072,20292948
2024-11-20 02:32:04,1858332,37248,504,195140,15324,1000856,366168,954476,316840,46380,49328,520908,359316,1269412,135828,696,1450072,20293140
2024-11-20 02:32:07,1858332,36948,504,195156,15308,1000884,366168,954504,316840,46380,49328,520908,359340,1269528,135828,696,1450072,20293156
2024-11-20 02:32:10,1858332,36368,504,195140,15308,1001764,366168,955384,316840,46380,49328,520908,359340,1270584,135832,696,1450072,20293100
2024-11-20 02:32:12,1858332,42860,504,195140,15308,995424,366116,948992,316840,46432,49276,520908,359352,1263912,135064,696,1450072,20292912
2024-11-20 02:32:15,1858332,42280,504,195140,15308,995476,366116,949044,316840,46432,49276,520908,359352,1263984,135080,696,1450072,20292940
2024-11-20 02:32:17,1858332,42564,504,195140,15308,995536,366112,949104,316836,46432,49276,520908,359352,1264144,134896,696,1450072,20293016
2024-11-20 02:32:20,1858332,42464,504,195140,15308,995676,366116,949244,316840,46432,49276,520908,359356,1264168,135100,696,1450072,20292944
2024-11-20 02:32:23,1858332,42240,504,195140,15308,995956,366116,949524,316840,46432,49276,520908,359356,1264632,135080,696,1450072,20292932
2024-11-20 02:32:25,1858332,42028,504,195140,15308,996224,366116,949792,316840,46432,49276,520908,359356,1264784,135052,696,1450072,20293016
2024-11-20 02:32:28,1858332,41764,504,195140,15308,996272,366116,949840,316840,46432,49276,520908,359356,1264756,135080,696,1450072,20292916
2024-11-20 02:32:30,1858332,41420,504,195140,15308,996456,366116,950024,316840,46432,49276,520908,359356,1265088,134792,696,1450072,20292952
2024-11-20 02:32:32,1858332,41116,504,195328,15308,996496,366284,950064,316840,46432,49444,520908,359356,1265104,135100,696,1450072,20292984
2024-11-20 02:32:35,1858332,37200,504,195320,15316,1000160,366304,953728,316840,46432,49464,520908,359356,1268720,138660,696,1450072,22214356
2024-11-20 02:32:38,1858332,44424,476,190312,15320,995068,364008,949400,318824,45668,45184,520908,359120,1266508,135828,696,1450072,20293108
2024-11-20 02:32:41,1858332,44628,476,190312,15320,995216,364008,949548,318824,45668,45184,520908,359120,1266552,135848,696,1450072,20292940
2024-11-20 02:32:43,1858332,44452,484,190312,15320,995628,364016,949960,318824,45668,45192,520908,359120,1266972,135828,696,1450072,20293084
2024-11-20 02:32:46,1858332,46920,484,190312,15320,992724,364016,947056,318824,45668,45192,520908,359128,1264188,135112,696,1450072,20293068
2024-11-20 02:32:48,1858332,46924,484,190312,15320,992672,364008,947004,318816,45668,45192,520908,359136,1264028,134912,696,1450072,20292840
2024-11-20 02:32:51,1858332,47068,484,190312,15320,992928,364008,947260,318816,45668,45192,520908,359136,1264496,135060,696,1450072,20292848
2024-11-20 02:32:54,1858332,47272,484,190312,15320,992932,364008,947264,318816,45668,45192,520908,359136,1264460,135096,696,1450072,20292948
2024-11-20 02:32:56,1858332,46836,484,190312,15320,993320,364012,947652,318820,45668,45192,520908,359168,1264692,135084,696,1450072,20292940
2024-11-20 02:32:59,1858332,46516,484,190312,15320,993928,364012,948260,318820,45668,45192,520908,359168,1265356,135064,696,1450072,20292996
2024-11-20 02:33:02,1858332,46444,484,190312,15320,993928,364012,948260,318820,45668,45192,520908,359168,1265132,134908,696,1450072,20293092
2024-11-20 02:33:04,1858332,45812,484,190312,15320,994484,364012,948816,318820,45668,45192,520908,359168,1265776,135044,696,1450072,20292996
2024-11-20 02:33:07,1858332,45356,484,190312,15320,994580,364012,948912,318820,45668,45192,520908,359168,1266136,135104,696,1450072,20292968
2024-11-20 02:33:09,1858332,45472,484,190312,15320,994872,364012,949204,318820,45668,45192,520908,359168,1266364,135112,696,1450072,20292988
2024-11-20 02:33:12,1858332,44996,484,190312,15320,995212,364012,949544,318820,45668,45192,520908,359168,1266328,134900,696,1450072,20293088
2024-11-20 02:33:14,1858332,45476,484,190312,15320,994996,364012,949328,318820,45668,45192,520908,359168,1266296,135012,696,1450072,20293048
2024-11-20 02:33:17,1858332,45032,484,190312,15320,995260,364012,949592,318820,45668,45192,520908,359180,1266744,135028,696,1450072,20293052
2024-11-20 02:33:20,1858332,45000,484,190312,15320,995176,364012,949508,318820,45668,45192,520908,359180,1266712,134920,696,1450072,20292872
2024-11-20 02:33:22,1858332,44956,484,190312,15320,995472,364012,949804,318820,45668,45192,520908,359180,1266788,135104,696,1450072,20293080
2024-11-20 02:33:25,1858332,44944,524,190272,15320,995836,364012,950168,318820,45668,45192,520908,359188,1267052,135104,696,1450072,20292892
2024-11-20 02:33:27,1858332,43708,604,190344,15312,996368,364080,950676,318828,45692,45252,520908,359196,1267532,135104,696,1450072,20292956
2024-11-20 02:33:29,1858332,41304,612,192388,15300,996616,366228,950904,318876,45712,47352,520908,359256,1268016,135124,696,1450072,20292948
2024-11-20 02:33:31,1858332,40908,612,192388,15300,996732,366228,951020,318876,45712,47352,520908,359256,1268000,135156,696,1450072,20293004
2024-11-20 02:33:33,1858332,40520,620,192380,15300,997004,366228,951292,318876,45712,47352,520908,359256,1268300,135156,696,1450072,20293056
2024-11-20 02:33:35,1858332,40560,620,192388,15300,996820,366236,951108,318876,45712,47360,520908,359256,1268076,135156,696,1450072,20293012
2024-11-20 02:33:37,1858332,40088,620,192388,15300,997432,366236,951720,318876,45712,47360,520908,359256,1268712,135156,696,1450072,20293076
2024-11-20 02:33:39,1858332,40108,620,192388,15300,997384,366236,951672,318876,45712,47360,520908,359256,1268728,135156,696,1450072,20293132
2024-11-20 02:33:42,1858332,39880,620,192388,15300,997452,366236,951740,318876,45712,47360,520908,359256,1268612,135156,696,1450072,20293128
2024-11-20 02:33:44,1858332,40644,620,192388,15292,997532,366252,951820,318892,45712,47360,520908,359280,1268944,135192,696,1450072,20292996
2024-11-20 02:33:47,1858332,40240,620,192388,15292,997792,366252,952080,318892,45712,47360,520908,359280,1269160,135156,696,1450072,20293004
2024-11-20 02:33:49,1858332,40124,620,192388,15292,997944,366252,952232,318892,45712,47360,520908,359280,1269348,135156,696,1450072,20293012
2024-11-20 02:33:52,1858332,39792,620,192388,15292,998060,366252,952348,318892,45712,47360,520908,359280,1269492,134944,696,1450072,20293124
2024-11-20 02:33:55,1858332,39572,620,192388,15292,998268,366252,952556,318892,45712,47360,520908,359280,1269732,134972,696,1450072,20292976
2024-11-20 02:33:57,1858332,39208,620,192388,15292,998532,366252,952820,318892,45712,47360,520908,359280,1270016,135156,696,1450072,20292972
2024-11-20 02:34:00,1858332,39360,620,192388,15292,998656,366252,952944,318892,45712,47360,520908,359280,1269896,135184,696,1450072,20292956
2024-11-20 02:34:03,1858332,38752,620,192388,15292,999176,366252,953464,318892,45712,47360,520908,359280,1270620,134972,696,1450072,20293020
2024-11-20 02:34:05,1858332,45104,620,192388,15292,992760,366252,947048,318892,45712,47360,520908,359280,1264148,135124,696,1450072,20292996
2024-11-20 02:34:08,1858332,44804,620,192388,15292,993040,366252,947328,318892,45712,47360,520908,359280,1264452,135156,696,1450072,20293028
2024-11-20 02:34:10,1858332,44628,620,192388,15292,993432,366252,947720,318892,45712,47360,520908,359280,1264700,135156,696,1450072,20293100
2024-11-20 02:34:12,1858332,44592,620,192388,15292,993428,366252,947716,318892,45712,47360,520908,359280,1264856,135156,696,1450072,20292880
2024-11-20 02:34:15,1858332,44500,620,192388,15292,993360,366252,947648,318892,45712,47360,520908,359280,1264716,135104,696,1450072,20292804
2024-11-20 02:34:17,1858332,44472,620,192388,15292,993604,366252,947892,318892,45712,47360,520908,359280,1265072,134972,696,1450072,20292884
2024-11-20 02:34:20,1858332,44448,620,192388,15292,993788,366252,948076,318892,45712,47360,520908,359280,1265116,135140,696,1450072,20292968
2024-11-20 02:34:22,1858332,43864,620,192388,15292,994048,366252,948336,318892,45712,47360,520908,359280,1265360,135156,696,1450072,20292892
2024-11-20 02:34:25,1858332,43760,620,192388,15292,993900,366252,948188,318892,45712,47360,520908,359280,1265192,135124,696,1450072,20293056
2024-11-20 02:34:28,1858332,43112,620,192388,15292,994864,366252,949152,318892,45712,47360,520908,359280,1266004,134972,696,1450072,20292960
2024-11-20 02:34:30,1858332,42936,620,192388,15292,995104,366252,949392,318892,45712,47360,520908,359280,1266780,135024,696,1450072,20292880
2024-11-20 02:34:33,1858332,42212,620,192388,15284,996056,366276,950344,318916,45712,47360,520908,359312,1267372,135160,696,1450072,20292928
2024-11-20 02:34:36,1858332,42196,620,192388,15284,995836,366276,950124,318916,45712,47360,520908,359312,1267508,134972,696,1450072,20293008
2024-11-20 02:34:38,1858332,41868,620,192388,15284,996476,366276,950764,318916,45712,47360,520908,359312,1267780,135200,696,1450072,20292904
2024-11-20 02:34:40,1858332,41760,620,192388,15284,996496,366276,950784,318916,45712,47360,520908,359312,1267732,135340,696,1450072,20292800
2024-11-20 02:34:43,1858332,41428,620,192388,15284,996644,366276,950932,318916,45712,47360,520908,359312,1267904,135316,696,1450072,20293008
2024-11-20 02:34:46,1858332,41536,620,192388,15284,996780,366276,951068,318916,45712,47360,520908,359312,1268016,135160,696,1450072,20292900
2024-11-20 02:34:48,1858332,40916,620,192388,15284,996968,366276,951256,318916,45712,47360,520908,359312,1268412,135060,696,1450072,20293088
2024-11-20 02:34:51,1858332,40600,620,192388,15284,997044,366276,951332,318916,45712,47360,520908,359312,1268468,134976,696,1450072,20293064
2024-11-20 02:34:54,1858332,40116,620,192388,15284,997536,366276,951824,318916,45712,47360,520908,359312,1268912,135344,696,1450072,20292924
2024-11-20 02:34:56,1858332,40400,620,192388,15284,997724,366280,952012,318920,45712,47360,520908,359316,1269088,135016,696,1450072,20292984
2024-11-20 02:34:59,1858332,40000,620,192388,15284,997680,366280,951968,318920,45712,47360,520908,359316,1269096,135164,696,1450072,20293008
2024-11-20 02:35:01,1858332,40412,620,192388,15284,997608,366280,951896,318920,45712,47360,520908,359316,1268916,134980,696,1450072,20292816
2024-11-20 02:35:04,1858332,40096,620,192388,15284,998104,366280,952392,318920,45712,47360,520908,359316,1269540,135164,696,1450072,20293048
2024-11-20 02:35:06,1858332,39720,620,192388,15284,998332,366280,952620,318920,45712,47360,520908,359316,1269676,134952,696,1450072,20293064
2024-11-20 02:35:09,1858332,39404,620,192388,15284,998792,366280,953080,318920,45712,47360,520908,359368,1270116,135184,696,1450072,20292828
2024-11-20 02:35:12,1858332,39456,620,192388,15284,998568,366280,952856,318920,45712,47360,520908,359368,1269932,135164,696,1450072,20292888
2024-11-20 02:35:14,1858332,39160,620,192388,15284,998880,366280,953168,318920,45712,47360,520908,359368,1270248,135164,696,1450072,20293112
2024-11-20 02:35:17,1858332,38900,620,192388,15284,998992,366280,953280,318920,45712,47360,520908,359368,1270352,135100,696,1450072,20292900
2024-11-20 02:35:19,1858332,38448,620,192388,15284,999432,366280,953720,318920,45712,47360,520908,359368,1270928,134980,696,1450072,20292944
2024-11-20 02:35:22,1858332,45096,620,192388,15284,993136,366280,947424,318920,45712,47360,520908,359368,1264468,135172,696,1450072,20292924
2024-11-20 02:35:25,1858332,44160,620,192388,15284,993944,366284,948232,318924,45712,47360,520908,359372,1265100,134988,696,1450072,20292972
2024-11-20 02:35:27,1858332,44580,620,192388,15284,993612,366284,947900,318924,45712,47360,520908,359372,1265164,135172,696,1450072,20292916
2024-11-20 02:35:30,1858332,44136,620,192388,15284,993728,366284,948016,318924,45712,47360,520908,359372,1265012,134988,696,1450072,20293028
2024-11-20 02:35:32,1858332,43800,620,192388,15284,993756,366284,948044,318924,45712,47360,520908,359372,1265272,134988,696,1450072,20293148
2024-11-20 02:35:35,1858332,43532,620,192388,15284,994300,366284,948588,318924,45712,47360,520908,359372,1265712,135160,696,1450072,20293120
2024-11-20 02:35:38,1858332,43468,620,192388,15284,994432,366284,948720,318924,45712,47360,520908,359372,1265744,134988,696,1450072,20293016
2024-11-20 02:35:40,1858332,43448,620,192388,15284,994736,366284,949024,318924,45712,47360,520908,359372,1266292,135112,696,1450072,20292968
2024-11-20 02:35:43,1858332,42956,620,192388,15284,995184,366284,949472,318924,45712,47360,520908,359372,1266480,135108,696,1450072,20292968
2024-11-20 02:35:46,1858332,44664,620,192944,15280,994936,364300,949224,316568,45712,47732,520908,359376,1263832,134988,696,1450072,20288780
2024-11-20 02:35:48,1858332,41540,660,194072,15284,997500,365428,951720,316412,45780,49016,520908,359388,1266328,135716,696,1450072,20292820
2024-11-20 02:35:50,1858332,41004,660,194072,15284,997840,365428,952060,316412,45780,49016,520908,359388,1266644,135664,696,1450072,20292864
2024-11-20 02:35:53,1858332,40892,660,194072,15284,997872,365428,952092,316412,45780,49016,520908,359388,1266656,135664,696,1450072,20292812
2024-11-20 02:35:55,1858332,40196,660,194072,15284,998612,365428,952832,316412,45780,49016,520908,359388,1267288,135664,696,1450072,20293096
2024-11-20 02:35:58,1858332,40184,660,194072,15284,998500,365428,952720,316412,45780,49016,520908,359388,1267216,135680,696,1450072,20293060
2024-11-20 02:36:01,1858332,40200,660,194072,15284,998804,365428,953024,316412,45780,49016,520908,359388,1267536,135664,696,1450072,20292936
2024-11-20 02:36:03,1858332,39676,660,194072,15284,998880,365428,953100,316412,45780,49016,520908,359388,1267540,135664,696,1450072,20292904
2024-11-20 02:36:06,1858332,39984,660,194072,15284,998956,365428,953176,316412,45780,49016,520908,359388,1267776,135664,696,1450072,20292848
2024-11-20 02:36:08,1858332,39640,660,194072,15284,999224,365428,953444,316412,45780,49016,520908,359388,1268212,135480,696,1450072,20293012
2024-11-20 02:36:11,1858332,39008,660,194072,15284,999428,365428,953648,316412,45780,49016,520908,359388,1268156,135848,696,1450072,20293008
2024-11-20 02:36:13,1858332,39352,660,194072,15284,999408,365428,953628,316412,45780,49016,520908,359388,1268204,135480,696,1450072,20293004
2024-11-20 02:36:16,1858332,39008,660,194072,15284,999748,365428,953968,316412,45780,49016,520908,359388,1268632,135664,696,1450072,20292876
2024-11-20 02:36:19,1858332,38920,660,194072,15284,999700,365428,953920,316412,45780,49016,520908,359388,1268664,135664,696,1450072,20293020
2024-11-20 02:36:21,1858332,38628,660,194072,15284,1000024,365428,954244,316412,45780,49016,520908,359388,1268816,135712,696,1450072,20293076
2024-11-20 02:36:24,1858332,38580,660,194072,15284,1000336,365428,954556,316412,45780,49016,520908,359388,1269116,135480,696,1450072,20292992
2024-11-20 02:36:26,1858332,38140,660,194072,15284,1000524,365428,954744,316412,45780,49016,520908,359388,1269156,135656,696,1450072,20292876
2024-11-20 02:36:29,1858332,38208,660,194072,15284,1000248,365428,954468,316412,45780,49016,520908,359388,1269028,135480,696,1450072,20292916
2024-11-20 02:36:31,1858332,37720,660,194072,15284,1000760,365428,954980,316412,45780,49016,520908,359388,1269704,135724,696,1450072,20292924
2024-11-20 02:36:34,1858332,37568,660,194072,15284,1000968,365428,955188,316412,45780,49016,520908,359388,1269976,135664,696,1450072,20293076
2024-11-20 02:36:36,1858332,37348,660,194072,15284,1001088,365428,955308,316412,45780,49016,520908,359388,1269864,135716,696,1450072,20292944
2024-11-20 02:36:39,1858332,37624,660,194072,15284,1001448,365428,955668,316412,45780,49016,520908,359388,1270200,135608,696,1450072,20292984
2024-11-20 02:36:42,1858332,37480,660,194072,15284,1001132,365428,955352,316412,45780,49016,520908,359388,1270056,135664,696,1450072,20292900
2024-11-20 02:36:44,1858332,37584,660,194072,15284,1001432,365428,955652,316412,45780,49016,520908,359388,1270124,135608,696,1450072,20293052
2024-11-20 02:36:46,1858332,36484,660,194072,15284,1001980,365428,956200,316412,45780,49016,520908,359388,1270724,135664,696,1450072,20292960
2024-11-20 02:36:49,1858332,36336,660,194072,15284,1002128,365428,956348,316412,45780,49016,520908,359388,1270928,135480,696,1450072,20292964
2024-11-20 02:36:51,1858332,35844,660,194072,15284,1002688,365428,956908,316412,45780,49016,520908,359388,1271448,135684,696,1450072,20293008
2024-11-20 02:36:54,1858332,42580,660,194072,15284,995664,365428,949884,316412,45780,49016,520908,359424,1264576,135704,696,1450072,20292968
2024-11-20 02:36:57,1858332,42292,660,194072,15284,995736,365432,949956,316416,45780,49016,520908,359456,1264476,135480,696,1450072,20293016
2024-11-20 02:36:59,1858332,42736,660,194072,15284,995692,365432,949912,316416,45780,49016,520908,359456,1264460,135616,696,1450072,20292832
2024-11-20 02:37:01,1858332,42928,660,194072,15284,995780,365432,950000,316416,45780,49016,520908,359456,1264576,135664,696,1450072,20292940
2024-11-20 02:37:04,1858332,42248,660,194072,15284,996364,365432,950584,316416,45780,49016,520908,359456,1265196,135768,696,1450072,20293016
2024-11-20 02:37:07,1858332,42288,660,194072,15284,996460,365432,950680,316416,45780,49016,520908,359456,1265304,135664,696,1450072,20292956
2024-11-20 02:37:09,1858332,41792,660,194072,15284,996428,365432,950648,316416,45780,49016,520908,359456,1265444,135484,696,1450072,20292980
2024-11-20 02:37:11,1858332,41280,660,194072,15284,996956,365432,951176,316416,45780,49016,520908,359456,1265696,135668,696,1450072,20292956
2024-11-20 02:37:14,1858332,40632,660,194072,15284,996844,365432,951064,316416,45780,49016,520908,359456,1265892,135668,696,1450072,20292876
2024-11-20 02:37:16,1858332,40352,660,194072,15284,997236,365436,951456,316420,45780,49016,520908,359460,1266000,135672,696,1450072,20293028
2024-11-20 02:37:18,1858332,40916,660,194072,15284,997140,365436,951360,316420,45780,49016,520908,359460,1265816,135672,696,1450072,20292984
2024-11-20 02:37:20,1858332,40584,660,194072,15284,997724,365436,951944,316420,45780,49016,520908,359460,1266488,135672,696,1450072,20293092
2024-11-20 02:37:23,1858332,40740,660,194072,15284,997616,365436,951836,316420,45780,49016,520908,359460,1266516,135672,696,1450072,20293088
2024-11-20 02:37:25,1858332,45588,644,189292,15284,995360,362328,950156,317532,45204,44796,520908,357960,1265844,136308,696,1450072,20293040
2024-11-20 02:37:27,1858332,45204,644,189432,15284,995632,362456,950428,317536,45204,44920,520908,357960,1266052,136420,696,1450072,20292992
2024-11-20 02:37:30,1858332,44344,660,189416,15284,996636,362448,951432,317528,45204,44920,520908,357968,1267036,136420,696,1450072,20293068
2024-11-20 02:37:32,1858332,47712,660,189440,15284,993144,362488,947936,317536,45208,44952,520908,357968,1263704,135668,696,1450072,20292932
2024-11-20 02:37:34,1858332,45692,664,191028,15296,993908,364208,948696,317664,45212,46544,520908,358084,1264528,135768,696,1450072,20293088
2024-11-20 02:37:36,1858332,45652,672,191028,15296,994088,364208,948876,317664,45212,46544,520908,358084,1264668,135768,696,1450072,20293076
2024-11-20 02:37:38,1858332,44280,672,191036,15288,994952,364216,949740,317664,45212,46552,520908,358104,1265572,135768,696,1450072,20293148
2024-11-20 02:37:41,1858332,43712,672,191028,15288,995260,364224,950048,317672,45212,46552,520908,358104,1265932,135768,696,1450072,20293064
2024-11-20 02:37:43,1858332,43820,672,191028,15288,995460,364224,950248,317672,45212,46552,520908,358104,1265980,135772,696,1450072,20293004
2024-11-20 02:37:45,1858332,43764,672,191028,15288,995452,364228,950240,317676,45212,46552,520908,358108,1266048,135768,696,1450072,20293004
2024-11-20 02:37:47,1858332,43656,672,191028,15288,995472,364228,950260,317676,45212,46552,520908,358108,1266080,135768,696,1450072,20293000
2024-11-20 02:37:49,1858332,43912,672,191028,15288,995548,364228,950336,317676,45212,46552,520908,358108,1266212,135768,696,1450072,20292964
2024-11-20 02:37:52,1858332,43948,672,191028,15288,995548,364228,950336,317676,45212,46552,520908,358108,1266140,135768,696,1450072,20293024
2024-11-20 02:37:54,1858332,43740,672,191028,15288,995812,364228,950600,317676,45212,46552,520908,358108,1266324,135768,696,1450072,20293012
2024-11-20 02:37:56,1858332,43688,672,191028,15288,995856,364228,950644,317676,45212,46552,520908,358108,1266584,135768,696,1450072,20293016
2024-11-20 02:37:58,1858332,43372,672,191028,15288,995968,364228,950756,317676,45212,46552,520908,358108,1266656,135584,696,1450072,20292940
2024-11-20 02:38:01,1858332,42904,672,191028,15288,996508,364228,951296,317676,45212,46552,520908,358108,1267152,135768,696,1450072,20292956
2024-11-20 02:38:03,1858332,42820,672,191028,15288,996464,364228,951252,317676,45212,46552,520908,358108,1267036,135768,696,1450072,20292984
2024-11-20 02:38:05,1858332,43004,672,191028,15288,996384,364228,951172,317676,45212,46552,520908,358108,1266976,135768,696,1450072,20293040
2024-11-20 02:38:07,1858332,42768,672,191028,15288,996520,364228,951308,317676,45212,46552,520908,358108,1267036,135768,696,1450072,20293036
2024-11-20 02:38:09,1858332,42580,672,191028,15288,996900,364228,951688,317676,45212,46552,520908,358108,1267532,135768,696,1450072,20293128
2024-11-20 02:38:11,1858332,42376,672,191028,15288,996924,364232,951712,317680,45212,46552,520908,358112,1267536,135768,696,1450072,20293088
2024-11-20 02:38:14,1858332,42352,672,191028,15288,996980,364232,951768,317680,45212,46552,520908,358112,1267580,135768,696,1450072,20293064
2024-11-20 02:38:16,1858332,42012,672,191028,15288,997096,364232,951884,317680,45212,46552,520908,358112,1267840,135768,696,1450072,20293048
2024-11-20 02:38:18,1858332,41748,672,191028,15288,997348,364232,952136,317680,45212,46552,520908,358112,1268004,135772,696,1450072,20293172
2024-11-20 02:38:21,1858332,41904,672,191028,15288,997336,364232,952124,317680,45212,46552,520908,358112,1268236,135772,696,1450072,20292968
2024-11-20 02:38:23,1858332,41992,672,191028,15288,997584,364232,952372,317680,45212,46552,520908,358112,1268344,135820,696,1450072,20293008
2024-11-20 02:38:26,1858332,41616,672,191028,15288,997924,364232,952712,317680,45212,46552,520908,358112,1268516,135716,696,1450072,20292996
2024-11-20 02:38:29,1858332,41732,672,191028,15288,997884,364232,952672,317680,45212,46552,520908,358112,1268588,135588,696,1450072,20293004
2024-11-20 02:38:31,1858332,41756,672,191028,15288,998052,364232,952840,317680,45212,46552,520908,358112,1268904,135816,696,1450072,20284700
2024-11-20 02:38:34,1858332,41324,672,191028,15288,998544,364232,953332,317680,45212,46552,520908,358112,1269256,135772,696,1450072,20292960
2024-11-20 02:38:36,1858332,41044,672,191028,15288,998604,364232,953392,317680,45212,46552,520908,358112,1269316,135608,696,1450072,20284888
2024-11-20 02:38:39,1858332,40876,672,191028,15288,998680,364232,953468,317680,45212,46552,520908,358112,1269384,135760,696,1450072,20293000
2024-11-20 02:38:41,1858332,40688,672,191028,15288,998888,364232,953676,317680,45212,46552,520908,358112,1269584,135772,696,1450072,20284812
2024-11-20 02:38:44,1858332,40488,672,191028,15288,999028,364232,953816,317680,45212,46552,520908,358112,1269812,135784,696,1450072,20292892
2024-11-20 02:38:46,1858332,40552,672,191028,15288,999180,364232,953968,317680,45212,46552,520908,358112,1269808,135788,696,1450072,20292880
2024-11-20 02:38:49,1858332,40444,672,191028,15288,999204,364232,953992,317680,45212,46552,520908,358112,1269740,135956,696,1450072,20292968
2024-11-20 02:38:51,1858332,40148,672,191028,15288,999844,364232,954632,317680,45212,46552,520908,358112,1270508,135776,696,1450072,20292992
2024-11-20 02:38:54,1858332,47036,672,191028,15288,992884,363976,947672,317424,45212,46552,520908,358112,1263404,135776,696,1450072,20293076
2024-11-20 02:38:56,1858332,46800,672,191028,15288,993392,363976,948180,317424,45212,46552,520908,358112,1263772,135776,696,1450072,20292940
2024-11-20 02:38:59,1858332,46688,672,191028,15288,993552,363976,948340,317424,45212,46552,520908,358112,1263960,135800,696,1450072,20292952
2024-11-20 02:39:02,1858332,46444,672,191028,15288,993336,363976,948124,317424,45212,46552,520908,358112,1263924,135776,696,1450072,20292892
2024-11-20 02:39:05,1858332,46096,672,191028,15288,993628,363976,948416,317424,45212,46552,520908,358112,1264132,135776,696,1450072,20292964
2024-11-20 02:39:07,1858332,46340,672,191028,15288,993840,363976,948628,317424,45212,46552,520908,358112,1264228,135592,696,1450072,20293032
2024-11-20 02:39:10,1858332,45780,672,191028,15288,994204,363976,948992,317424,45212,46552,520908,358112,1264548,135736,696,1450072,20292816
2024-11-20 02:39:13,1858332,45692,672,191028,15288,994376,363976,949164,317424,45212,46552,520908,358112,1264632,135592,696,1450072,20292932
2024-11-20 02:39:15,1858332,45448,672,191028,15288,994684,363976,949472,317424,45212,46552,520908,358176,1265012,135796,696,1450072,20292904
2024-11-20 02:39:18,1858332,45396,672,191028,15288,994848,363976,949636,317424,45212,46552,520908,358176,1265036,135724,696,1450072,20292948
2024-11-20 02:39:20,1858332,45316,672,191028,15288,994816,363976,949604,317424,45212,46552,520908,358176,1265088,135776,696,1450072,20292996
2024-11-20 02:39:23,1858332,45412,672,191028,15288,994768,363976,949556,317424,45212,46552,520908,358176,1265100,135668,696,1450072,20292988
2024-11-20 02:39:26,1858332,44924,672,191028,15288,995148,363976,949936,317424,45212,46552,520908,358176,1265596,135776,696,1450072,20293100
2024-11-20 02:39:28,1858332,45012,672,191028,15288,995608,363976,950396,317424,45212,46552,520908,358176,1265928,135796,696,1450072,20293008
2024-11-20 02:39:31,1858332,44456,672,191028,15288,995864,363976,950652,317424,45212,46552,520908,358176,1266312,135776,696,1450072,20293088
2024-11-20 02:39:33,1858332,44160,672,191028,15288,996468,363976,951256,317424,45212,46552,520908,358176,1266828,135776,696,1450072,20293048
2024-11-20 02:39:36,1858332,44168,672,191076,15288,996500,363976,951288,317424,45212,46552,520908,358176,1266932,135596,696,1450072,20293096
2024-11-20 02:39:38,1858332,43836,672,191076,15288,996740,364024,951528,317424,45212,46600,520908,358176,1267232,135832,696,1450072,20292972
2024-11-20 02:39:41,1858332,43340,672,191076,15288,997052,364024,951840,317424,45212,46600,520908,358176,1267324,135780,696,1450072,20293036
2024-11-20 02:39:44,1858332,43108,672,191076,15288,997196,364024,951984,317424,45212,46600,520908,358176,1267756,135780,696,1450072,20293000
2024-11-20 02:39:46,1858332,43076,672,191076,15288,997264,364024,952052,317424,45212,46600,520908,358176,1267612,135720,696,1450072,20292980
2024-11-20 02:39:49,1858332,42552,672,191076,15288,997472,364024,952260,317424,45212,46600,520908,358176,1267852,135780,696,1450072,20292928
2024-11-20 02:39:51,1858332,42440,672,191076,15288,997692,364024,952480,317424,45212,46600,520908,358176,1267920,135648,696,1450072,20292964
2024-11-20 02:39:54,1858332,42548,672,191076,15288,997872,364024,952660,317424,45212,46600,520908,358176,1268144,135780,696,1450072,20292960
2024-11-20 02:39:56,1858332,42360,672,191076,15288,998056,364024,952844,317424,45212,46600,520908,358176,1268424,135784,696,1450072,20293108
2024-11-20 02:39:59,1858332,38684,672,194108,15376,998304,367392,953080,317804,45224,49588,520908,357964,1268972,136256,696,1450072,20293020
2024-11-20 02:40:01,1858332,45124,672,194112,15376,991976,367432,946752,317812,45224,49620,520908,357992,1262864,136256,696,1450072,20292872
2024-11-20 02:40:04,1858332,44960,672,194108,15376,992572,367432,947348,317812,45224,49620,520908,357996,1263204,136280,696,1450072,20292816
2024-11-20 02:40:07,1858332,44564,672,194108,15376,992600,367432,947376,317812,45224,49620,520908,357996,1263304,136256,696,1450072,20292920
2024-11-20 02:40:09,1858332,44404,672,194108,15376,992832,367432,947608,317812,45224,49620,520908,357996,1263508,136276,696,1450072,20292948
2024-11-20 02:40:12,1858332,44584,672,194108,15376,993336,367432,948112,317812,45224,49620,520908,357996,1264092,136200,696,1450072,20292912
2024-11-20 02:40:14,1858332,43568,672,194108,15376,993768,367432,948544,317812,45224,49620,520908,357996,1264336,136256,696,1450072,20293092
2024-11-20 02:40:17,1858332,43576,672,194108,15376,994168,367432,948944,317812,45224,49620,520908,357996,1264888,136260,696,1450072,20292856
2024-11-20 02:40:20,1858332,42868,672,194108,15376,995000,367432,949776,317812,45224,49620,520908,358000,1265648,136072,696,1450072,20293168
2024-11-20 02:40:22,1858332,42524,672,194108,15376,995136,367436,949912,317816,45224,49620,520908,358000,1265788,136276,696,1450072,20292872
2024-11-20 02:40:25,1858332,42252,672,194108,15376,995268,367436,950044,317816,45224,49620,520908,358000,1265884,136256,696,1450072,20292992
2024-11-20 02:40:27,1858332,41944,672,194108,15376,995488,367436,950264,317816,45224,49620,520908,358000,1266072,136280,696,1450072,20293000
2024-11-20 02:40:30,1858332,42156,672,194108,15376,995308,367436,950084,317816,45224,49620,520908,358000,1266236,136440,696,1450072,20292880
2024-11-20 02:40:32,1858332,41524,672,194108,15376,996036,367436,950812,317816,45224,49620,520908,358000,1266668,136200,696,1450072,20293136
2024-11-20 02:40:35,1858332,41112,672,194108,15376,996472,367436,951248,317816,45224,49620,520908,358000,1267172,136256,696,1450072,20293080
2024-11-20 02:40:37,1858332,41052,672,194108,15376,996348,367436,951124,317816,45224,49620,520908,358000,1267036,136164,696,1450072,20293024
2024-11-20 02:40:40,1858332,40680,672,194108,15376,996624,367436,951400,317816,45224,49620,520908,358000,1267492,136256,696,1450072,20292996
2024-11-20 02:40:42,1858332,40492,672,194108,15376,997060,367436,951836,317816,45224,49620,520908,358000,1267672,136308,696,1450072,20292976
2024-11-20 02:40:45,1858332,40344,672,194108,15376,997240,367436,952016,317816,45224,49620,520908,358004,1267992,136264,696,1450072,20293112
2024-11-20 02:40:47,1858332,39920,672,194108,15376,997548,367444,952324,317824,45224,49620,520908,358012,1268308,136272,696,1450072,20284836
2024-11-20 02:40:50,1858332,39756,672,194108,15380,998064,367452,952840,317832,45224,49620,520908,358012,1268764,136176,696,1450072,20293004
2024-11-20 02:40:53,1858332,39556,672,194108,15380,997920,367452,952696,317832,45224,49620,520908,358012,1268736,136088,696,1450072,20284828
2024-11-20 02:40:55,1858332,39240,672,194108,15380,998124,367452,952900,317832,45224,49620,520908,358012,1269016,136288,696,1450072,20292912
2024-11-20 02:40:58,1858332,38872,672,194108,15380,998120,367452,952896,317832,45224,49620,520908,358012,1269076,136272,696,1450072,20292964
2024-11-20 02:41:00,1858332,38512,672,194108,15380,998688,367452,953464,317832,45224,49620,520908,358012,1269576,136272,696,1450072,20292844
2024-11-20 02:41:03,1858332,44620,672,194108,15380,992496,367452,947272,317832,45224,49620,520908,358012,1263236,136300,696,1450072,20292972
2024-11-20 02:41:05,1858332,44728,672,194108,15380,992488,367452,947264,317832,45224,49620,520908,358012,1263388,136272,696,1450072,20292960
2024-11-20 02:41:08,1858332,44460,672,194108,15380,992560,367452,947336,317832,45224,49620,520908,358012,1263384,136276,696,1450072,20292924
2024-11-20 02:41:11,1858332,44740,672,194108,15380,992644,367452,947420,317832,45224,49620,520908,358012,1263440,136272,696,1450072,20293072
2024-11-20 02:41:13,1858332,44536,672,194108,15380,992756,367452,947532,317832,45224,49620,520908,358012,1263652,136312,696,1450072,20293068
2024-11-20 02:41:16,1858332,44396,672,194108,15380,993220,367452,947996,317832,45224,49620,520908,358012,1263968,136300,696,1450072,20292984
2024-11-20 02:41:19,1858332,43944,672,194108,15380,993348,367452,948124,317832,45224,49620,520908,358012,1264104,136272,696,1450072,20292992
2024-11-20 02:41:21,1858332,43720,672,194108,15380,993508,367452,948284,317832,45224,49620,520908,358012,1264164,136276,696,1450072,20292848
2024-11-20 02:41:24,1858332,43360,672,194108,15380,993944,367452,948720,317832,45224,49620,520908,358012,1264684,136296,696,1450072,20292952
2024-11-20 02:41:26,1858332,43692,672,194108,15380,993616,367452,948392,317832,45224,49620,520908,358012,1264336,136272,696,1450072,20292776
2024-11-20 02:41:29,1858332,43520,672,194108,15380,993916,367452,948692,317832,45224,49620,520908,358012,1264624,136376,696,1450072,20292944
2024-11-20 02:41:32,1858332,43336,672,194108,15380,994260,367452,949036,317832,45224,49620,520908,358012,1264924,136272,696,1450072,20292960
2024-11-20 02:41:34,1858332,42768,672,194108,15380,994568,367456,949344,317836,45224,49620,520908,358016,1265320,136140,696,1450072,20293024
2024-11-20 02:41:37,1858332,42644,672,194108,15380,994840,367456,949616,317836,45224,49620,520908,358016,1265628,136272,696,1450072,20292852
2024-11-20 02:41:40,1858332,42184,672,194108,15380,995088,367456,949864,317836,45224,49620,520908,358016,1265844,136272,696,1450072,20292984
2024-11-20 02:41:42,1858332,42332,672,194108,15380,995028,367456,949804,317836,45224,49620,520908,358016,1265972,136324,696,1450072,20292972
2024-11-20 02:41:45,1858332,41944,672,194108,15380,995324,367456,950100,317836,45224,49620,520908,358016,1265980,136272,696,1450072,20292980
2024-11-20 02:41:47,1858332,41896,672,194108,15380,995204,367456,949980,317836,45224,49620,520908,358016,1265940,136324,696,1450072,20293088
2024-11-20 02:41:50,1858332,41708,672,194108,15380,995632,367456,950408,317836,45224,49620,520908,358016,1266300,136216,696,1450072,20292860
2024-11-20 02:41:52,1858332,41732,672,194108,15380,995500,367456,950276,317836,45224,49620,520908,358016,1266388,136272,696,1450072,20293044
2024-11-20 02:41:55,1858332,41280,672,194108,15380,996148,367456,950924,317836,45224,49620,520908,358016,1266776,136324,696,1450072,20293040
2024-11-20 02:41:58,1858332,41312,672,194108,15380,996172,367456,950948,317836,45224,49620,520908,358016,1266876,136088,696,1450072,20293028
2024-11-20 02:42:00,1858332,41092,672,194108,15380,996296,367456,951072,317836,45224,49620,520908,358016,1266980,136296,696,1450072,20292888
2024-11-20 02:42:03,1858332,41244,672,194108,15380,996176,367456,950952,317836,45224,49620,520908,358016,1266940,136272,696,1450072,20293104
2024-11-20 02:42:05,1858332,41108,672,194108,15380,996436,367456,951212,317836,45224,49620,520908,358016,1267320,136292,696,1450072,20293104
2024-11-20 02:42:08,1858332,40360,672,194108,15380,996604,367460,951380,317840,45224,49620,520908,358020,1267460,136272,696,1450072,20292848
2024-11-20 02:42:10,1858332,40444,672,194108,15380,997268,367476,952044,317856,45224,49620,520908,358416,1267844,136324,696,1450072,20293052
2024-11-20 02:42:12,1858332,40236,672,194108,15380,997436,367476,952212,317856,45224,49620,520908,358416,1268408,136272,696,1450072,20292844
2024-11-20 02:42:15,1858332,39940,672,194108,15380,997520,367476,952296,317856,45224,49620,520908,358416,1268424,136180,696,1450072,20292972
2024-11-20 02:42:18,1858332,39752,672,194108,15380,997796,367476,952572,317856,45224,49620,520908,358416,1268496,136088,696,1450072,20292916
2024-11-20 02:42:20,1858332,39520,672,194108,15380,997808,367476,952584,317856,45224,49620,520908,358416,1268588,136324,696,1450072,20292980
2024-11-20 02:42:23,1858332,39468,672,194108,15380,997988,367476,952764,317856,45224,49620,520908,358416,1268992,136272,696,1450072,20292856
2024-11-20 02:42:25,1858332,39088,672,194108,15380,998000,367476,952776,317856,45224,49620,520908,358416,1268900,136324,696,1450072,20292964
2024-11-20 02:42:28,1858332,38320,672,194108,15380,999100,367476,953876,317856,45224,49620,520908,358416,1269884,136288,696,1450072,20293000
2024-11-20 02:42:31,1858332,44456,672,194108,15380,992248,367476,947024,317856,45224,49620,520908,358416,1263288,136272,696,1450072,20293020
2024-11-20 02:42:33,1858332,44416,672,194108,15380,992532,367476,947308,317856,45224,49620,520908,358416,1263440,136324,696,1450072,20293008
2024-11-20 02:42:36,1858332,44404,672,194108,15380,992484,367476,947260,317856,45224,49620,520908,358416,1263448,136088,696,1450072,20292968
2024-11-20 02:42:38,1858332,44352,672,194108,15380,992864,367476,947640,317856,45224,49620,520908,358416,1263916,136092,696,1450072,20293032
2024-11-20 02:42:41,1858332,43984,672,194108,15380,992868,367476,947644,317856,45224,49620,520908,358416,1263772,136300,696,1450072,20293004
2024-11-20 02:42:44,1858332,43992,672,194108,15380,992956,367476,947732,317856,45224,49620,520908,358416,1263784,136276,696,1450072,20292976
2024-11-20 02:42:46,1858332,43608,672,194108,15380,993496,367476,948272,317856,45224,49620,520908,358416,1264564,136296,696,1450072,20293008
2024-11-20 02:42:49,1858332,43576,672,194108,15380,993496,367476,948272,317856,45224,49620,520908,358416,1264508,136096,696,1450072,20292880
2024-11-20 02:42:51,1858332,43212,672,194108,15380,993920,367476,948696,317856,45224,49620,520908,358416,1264668,136172,696,1450072,20292900
2024-11-20 02:42:54,1858332,42940,672,194108,15380,994256,367476,949032,317856,45224,49620,520908,358416,1264856,136308,696,1450072,20292844
2024-11-20 02:42:57,1858332,42504,672,194108,15380,994676,367476,949452,317856,45224,49620,520908,358420,1265396,136284,696,1450072,20292992
2024-11-20 02:42:59,1858332,41548,672,194108,15380,995568,367476,950344,317856,45224,49620,520908,358420,1266412,136284,696,1450072,20293088
2024-11-20 02:43:02,1858332,41416,672,194108,15380,995708,367476,950484,317856,45224,49620,520908,358420,1266492,136284,696,1450072,20293092
2024-11-20 02:43:05,1858332,41088,672,194108,15380,996108,367476,950884,317856,45224,49620,520908,358420,1266824,136228,696,1450072,20292940
2024-11-20 02:43:07,1858332,40872,672,194108,15380,996156,367480,950932,317860,45224,49620,520908,358424,1266768,136284,696,1450072,20292860
2024-11-20 02:43:10,1858332,40588,672,194108,15380,996416,367480,951192,317860,45224,49620,520908,358424,1267256,136144,696,1450072,20292856
2024-11-20 02:43:13,1858332,40188,672,194108,15380,996668,367480,951444,317860,45224,49620,520908,358424,1267572,136100,696,1450072,20292940
2024-11-20 02:43:16,1858332,40196,672,194108,15380,996540,367480,951316,317860,45224,49620,520908,358424,1267352,136284,696,1450072,20293040
2024-11-20 02:43:18,1858332,40300,672,194108,15380,996684,367480,951460,317860,45224,49620,520908,358424,1267460,136304,696,1450072,20293044
2024-11-20 02:43:21,1858332,39840,672,194108,15380,997232,367480,952008,317860,45224,49620,520908,358424,1267940,136264,696,1450072,20293136
2024-11-20 02:43:24,1858332,39380,672,194108,15380,997656,367480,952432,317860,45224,49620,520908,358424,1268496,136284,696,1450072,20292952
2024-11-20 02:43:26,1858332,39092,672,194108,15380,998068,367480,952844,317860,45224,49620,520908,358424,1268884,136308,696,1450072,20292868
2024-11-20 02:43:29,1858332,38792,672,194108,15380,998272,367480,953048,317860,45224,49620,520908,358424,1269136,136284,696,1450072,20292904
2024-11-20 02:43:31,1858332,38664,672,194108,15380,998332,367480,953108,317860,45224,49620,520908,358424,1269076,136284,696,1450072,20292928
2024-11-20 02:43:34,1858332,38432,672,194108,15380,998972,367480,953748,317860,45224,49620,520908,358424,1269812,136328,696,1450072,20292988
2024-11-20 02:43:37,1858332,43888,672,194108,15380,992560,367484,947336,317864,45224,49620,520908,358428,1263584,136284,696,1450072,20292888
2024-11-20 02:43:39,1858332,43956,672,194108,15380,992836,367484,947612,317864,45224,49620,520908,358428,1263804,136284,696,1450072,20292968
2024-11-20 02:43:42,1858332,44204,672,194108,15380,992948,367484,947724,317864,45224,49620,520908,358428,1263728,136288,696,1450072,20292936
2024-11-20 02:43:45,1858332,44052,672,194108,15380,993164,367484,947940,317864,45224,49620,520908,358428,1263852,136468,696,1450072,20293076
2024-11-20 02:43:47,1858332,43780,672,194108,15380,993264,367488,948040,317868,45224,49620,520908,358432,1264312,136336,696,1450072,20292996
2024-11-20 02:43:50,1858332,43500,672,194108,15380,993356,367488,948132,317868,45224,49620,520908,358432,1264332,136100,696,1450072,20292956
2024-11-20 02:43:52,1858332,43344,672,194108,15380,993584,367488,948360,317868,45224,49620,520908,358432,1264172,136284,696,1450072,20292972
2024-11-20 02:43:55,1858332,43096,672,194108,15380,994040,367488,948816,317868,45224,49620,520908,358432,1264856,136308,696,1450072,20293036
2024-11-20 02:43:58,1858332,42720,672,194108,15380,994428,367488,949204,317868,45224,49620,520908,358432,1265144,136100,696,1450072,20293076
2024-11-20 02:44:00,1858332,42264,672,194108,15380,994780,367488,949556,317868,45224,49620,520908,358432,1265760,136336,696,1450072,20292980
2024-11-20 02:44:03,1858332,41680,672,194108,15380,995700,367488,950476,317868,45224,49620,520908,358432,1266448,136312,696,1450072,20293076
2024-11-20 02:44:06,1858332,41344,672,194108,15380,995668,367488,950444,317868,45224,49620,520908,358432,1266592,136288,696,1450072,20292884
2024-11-20 02:44:08,1858332,41284,672,194108,15380,995804,367496,950580,317876,45224,49620,520908,358440,1266540,136308,696,1450072,20293024
2024-11-20 02:44:11,1858332,41004,672,194108,15380,995940,367496,950716,317876,45224,49620,520908,358440,1266608,136272,696,1450072,20293056
2024-11-20 02:44:14,1858332,41004,672,194108,15380,996116,367496,950892,317876,45224,49620,520908,358440,1266804,136104,696,1450072,20292868
2024-11-20 02:44:16,1858332,40772,672,194108,15380,996372,367496,951148,317876,45224,49620,520908,358440,1267456,136308,696,1450072,20292988
2024-11-20 02:44:19,1858332,40760,672,194108,15380,996624,367496,951400,317876,45224,49620,520908,358440,1267380,136288,696,1450072,20292992
2024-11-20 02:44:21,1858332,39968,672,194108,15380,997260,367496,952036,317876,45224,49620,520908,358440,1268168,136308,696,1450072,20293024
2024-11-20 02:44:24,1858332,40216,672,194108,15380,997136,367496,951912,317876,45224,49620,520908,358440,1268132,136288,696,1450072,20292756
2024-11-20 02:44:26,1858332,39712,672,194108,15380,997512,367496,952288,317876,45224,49620,520908,358440,1268404,136292,696,1450072,20292980
2024-11-20 02:44:29,1858332,39516,672,194108,15380,997996,367496,952772,317876,45224,49620,520908,358440,1268704,136288,696,1450072,20293068
2024-11-20 02:44:31,1858332,38728,672,194108,15380,998556,367496,953332,317876,45224,49620,520908,358440,1269316,136324,696,1450072,20293056
2024-11-20 02:44:34,1858332,38960,672,194108,15380,998516,367496,953292,317876,45224,49620,520908,358440,1269380,136288,696,1450072,20292912
2024-11-20 02:44:37,1858332,38344,672,194108,15380,998728,367496,953504,317876,45224,49620,520908,358440,1269404,136104,696,1450072,20293004
2024-11-20 02:44:39,1858332,38348,672,194108,15380,998708,367496,953484,317876,45224,49620,520908,358440,1269436,136248,696,1450072,20292884
2024-11-20 02:44:42,1858332,38492,672,194108,15380,998804,367496,953580,317876,45224,49620,520908,358440,1269664,136288,696,1450072,20292988
2024-11-20 02:44:44,1858332,38192,672,194108,15380,998872,367496,953648,317876,45224,49620,520908,358440,1269784,136340,696,1450072,20293072
2024-11-20 02:44:47,1858332,37788,672,194108,15380,999556,367496,954332,317876,45224,49620,520908,358440,1270300,136312,696,1450072,20293124
2024-11-20 02:44:49,1858332,43984,672,194108,15380,992804,367496,947580,317876,45224,49620,520908,358440,1263840,136288,696,1450072,20293060
2024-11-20 02:44:52,1858332,43980,672,194108,15380,993140,367496,947916,317876,45224,49620,520908,358440,1264004,136312,696,1450072,20293024
2024-11-20 02:44:55,1858332,44232,672,194108,15380,992896,367496,947672,317876,45224,49620,520908,358440,1263536,136104,696,1450072,20292888
2024-11-20 02:44:58,1858332,46476,672,194108,15380,991424,367372,946076,317876,45348,49496,520908,358460,1262088,136472,696,1450072,20292920
2024-11-20 02:45:00,1858332,44196,672,194108,15380,993804,367228,948300,317888,45504,49340,520908,358460,1264516,136256,696,1450072,20292960
2024-11-20 02:45:02,1858332,43872,672,194108,15380,993960,367228,948456,317888,45504,49340,520908,358460,1264528,136292,696,1450072,20292972
2024-11-20 02:45:05,1858332,43568,672,194108,15380,994336,367228,948832,317888,45504,49340,520908,358460,1264960,136316,696,1450072,20292960
2024-11-20 02:45:07,1858332,42948,672,194108,15380,994704,367228,949200,317888,45504,49340,520908,358460,1265116,136292,696,1450072,20293020
2024-11-20 02:45:10,1858332,42896,672,194108,15380,994472,367228,948968,317888,45504,49340,520908,358460,1265188,136292,696,1450072,20293132
2024-11-20 02:45:12,1858332,42612,672,194108,15380,994776,367228,949272,317888,45504,49340,520908,358460,1265492,136108,696,1450072,20293004
2024-11-20 02:45:15,1858332,42516,672,194108,15380,994900,367228,949396,317888,45504,49340,520908,358460,1265492,136292,696,1450072,20284964
2024-11-20 02:45:17,1858332,42452,672,194108,15380,995272,367228,949768,317888,45504,49340,520908,358460,1265788,136312,696,1450072,20293156
2024-11-20 02:45:20,1858332,42708,672,194108,15380,995188,367228,949684,317888,45504,49340,520908,358460,1265596,136292,696,1450072,20292976
2024-11-20 02:45:22,1858332,42564,672,194108,15380,995240,367228,949736,317888,45504,49340,520908,358460,1265808,136292,696,1450072,20293028
2024-11-20 02:45:25,1858332,42072,672,194108,15380,995632,367228,950128,317888,45504,49340,520908,358460,1266060,136292,696,1450072,20293032
2024-11-20 02:45:27,1858332,42048,672,194108,15380,995680,367228,950176,317888,45504,49340,520908,358460,1266380,136108,696,1450072,20292880
2024-11-20 02:45:30,1858332,41844,672,194108,15380,996156,367228,950652,317888,45504,49340,520908,358460,1266644,136316,696,1450072,20293036
2024-11-20 02:45:33,1858332,41384,672,194108,15380,996376,367228,950872,317888,45504,49340,520908,358460,1267164,136108,696,1450072,20293064
2024-11-20 02:45:35,1858332,40600,672,194108,15380,997256,367228,951752,317888,45504,49340,520908,358460,1267900,136312,696,1450072,20292972
2024-11-20 02:45:38,1858332,40044,672,194372,15380,997592,367492,952088,317888,45504,49604,520908,358460,1268132,136328,696,1450072,20293096
2024-11-20 02:45:41,1858332,38684,672,194372,15380,998720,367492,953216,317888,45504,49604,520908,358460,1269180,136124,696,1450072,20292908
2024-11-20 02:45:43,1858332,38464,672,194372,15380,998772,367492,953268,317888,45504,49604,520908,358460,1269356,136244,696,1450072,20292888
2024-11-20 02:45:46,1858332,38248,672,194372,15376,999388,367492,953884,317888,45504,49604,520908,358464,1269868,136308,696,1450072,20292984
2024-11-20 02:45:48,1858332,43932,672,194372,15376,993192,367492,947688,317888,45504,49604,520908,358468,1263696,136328,696,1450072,20293000
2024-11-20 02:45:51,1858332,43888,672,194372,15376,993044,367492,947540,317888,45504,49604,520908,358468,1263760,136308,696,1450072,20293016
2024-11-20 02:45:53,1858332,43980,672,194372,15376,993280,367492,947776,317888,45504,49604,520908,358468,1263916,136308,696,1450072,20292892
2024-11-20 02:45:56,1858332,43656,672,194372,15376,993900,367492,948396,317888,45504,49604,520908,358468,1264428,136324,696,1450072,20293076
2024-11-20 02:45:59,1858332,43400,672,194372,15376,994128,367492,948624,317888,45504,49604,520908,358468,1264800,136308,696,1450072,20292960
2024-11-20 02:46:01,1858332,43248,672,194372,15376,994452,367492,948948,317888,45504,49604,520908,358468,1264916,136352,696,1450072,20292944
2024-11-20 02:46:04,1858332,42932,672,194372,15376,994700,367492,949196,317888,45504,49604,520908,358468,1265244,136308,696,1450072,20292960
2024-11-20 02:46:06,1858332,42328,672,194372,15376,995196,367492,949692,317888,45504,49604,520908,358468,1265868,136308,696,1450072,20293068
2024-11-20 02:46:09,1858332,41840,672,194372,15376,995440,367492,949936,317888,45504,49604,520908,358468,1265956,136332,696,1450072,20292996
2024-11-20 02:46:12,1858332,41832,672,194372,15376,995576,367492,950072,317888,45504,49604,520908,358468,1266184,136124,696,1450072,20292996
2024-11-20 02:46:14,1858332,41360,672,194372,15376,995496,367492,949992,317888,45504,49604,520908,358468,1266224,136308,696,1450072,20292876
2024-11-20 02:46:17,1858332,41472,672,194372,15376,995704,367492,950200,317888,45504,49604,520908,358468,1266256,136308,696,1450072,20293120
2024-11-20 02:46:19,1858332,41344,672,194372,15376,995772,367492,950268,317888,45504,49604,520908,358468,1266328,136308,696,1450072,20292964
2024-11-20 02:46:22,1858332,40880,672,194372,15376,996332,367492,950828,317888,45504,49604,520908,358468,1266880,136124,696,1450072,20292900
2024-11-20 02:46:24,1858332,40728,672,194372,15376,996356,367492,950852,317888,45504,49604,520908,358468,1266868,136176,696,1450072,20293068
2024-11-20 02:46:27,1858332,40608,672,194372,15376,996732,367492,951228,317888,45504,49604,520908,358468,1267256,136332,696,1450072,20292984
2024-11-20 02:46:30,1858332,40420,672,194372,15376,996764,367492,951260,317888,45504,49604,520908,358468,1267528,136308,696,1450072,20292880
2024-11-20 02:46:32,1858332,40004,672,194372,15376,997384,367496,951880,317892,45504,49604,520908,358472,1267860,136184,696,1450072,20293016
2024-11-20 02:46:35,1858332,40252,672,194372,15376,997308,367496,951804,317892,45504,49604,520908,358472,1267856,136124,696,1450072,20292988
2024-11-20 02:46:37,1858332,39360,672,194368,15380,997676,367496,952172,317892,45504,49604,520908,358476,1268116,136308,696,1450072,20293020
2024-11-20 02:46:40,1858332,38876,672,194372,15376,997812,367504,952308,317900,45504,49604,520908,358480,1268360,136260,696,1450072,20292964
2024-11-20 02:46:42,1858332,38740,672,194372,15376,997672,367504,952168,317900,45504,49604,520908,358480,1268400,136308,696,1450072,20292972
2024-11-20 02:46:45,1858332,38556,672,194372,15376,998448,367504,952944,317900,45504,49604,520908,358480,1269116,136324,696,1450072,20292952
2024-11-20 02:46:47,1858332,38400,672,194372,15376,998668,367504,953164,317900,45504,49604,520908,358480,1269068,136308,696,1450072,20292972
2024-11-20 02:46:50,1858332,38124,672,194372,15376,998664,367504,953160,317900,45504,49604,520908,358480,1269272,136368,696,1450072,20292940
2024-11-20 02:46:53,1858332,38000,672,194372,15376,998968,367504,953464,317900,45504,49604,520908,358480,1269448,136124,696,1450072,20292848
2024-11-20 02:46:56,1858332,36992,748,194296,15376,1000076,367504,954572,317900,45504,49604,520908,358496,1270732,136308,696,1450072,20292976
2024-11-20 02:46:58,1858332,39300,748,194388,15376,997412,367608,951904,317916,45508,49692,520908,358496,1267936,136328,696,1450072,20293008
2024-11-20 02:47:01,1858332,42864,756,194380,15376,994220,367612,948712,317920,45508,49692,520908,358500,1264780,136332,696,1450072,20292956
2024-11-20 02:47:04,1858332,42604,756,194388,15376,993988,367620,948480,317920,45508,49700,520908,358500,1264816,136308,696,1450072,20292896
2024-11-20 02:47:06,1858332,42280,756,194388,15376,994596,367620,949088,317920,45508,49700,520908,358500,1265188,136308,696,1450072,20292876
2024-11-20 02:47:09,1858332,41660,756,194388,15376,994996,367620,949488,317920,45508,49700,520908,358500,1265328,136308,696,1450072,20292960
2024-11-20 02:47:11,1858332,41940,756,194388,15376,995056,367620,949548,317920,45508,49700,520908,358500,1265764,136352,696,1450072,20292976
2024-11-20 02:47:14,1858332,41592,756,194388,15376,995148,367620,949640,317920,45508,49700,520908,358500,1265600,136308,696,1450072,20292892
2024-11-20 02:47:16,1858332,41484,756,194388,15376,995176,367620,949668,317920,45508,49700,520908,358500,1265720,136360,696,1450072,20292840
2024-11-20 02:47:19,1858332,41384,756,194388,15376,995432,367620,949924,317920,45508,49700,520908,358500,1265888,136308,696,1450072,20292944
2024-11-20 02:47:21,1858332,41160,756,194388,15376,995644,367620,950136,317920,45508,49700,520908,358500,1266352,136328,696,1450072,20293104
2024-11-20 02:47:24,1858332,40884,756,194388,15376,995868,367620,950360,317920,45508,49700,520908,358500,1266364,136124,696,1450072,20292956
2024-11-20 02:47:26,1858332,40388,756,194388,15376,996068,367620,950560,317920,45508,49700,520908,358500,1266576,136308,696,1450072,20293000
2024-11-20 02:47:29,1858332,40440,756,194388,15376,996196,367620,950688,317920,45508,49700,520908,358500,1266724,136356,696,1450072,20293112
2024-11-20 02:47:32,1858332,39892,756,194388,15376,996384,367632,950876,317932,45508,49700,520908,358512,1266892,136312,696,1450072,20293136
2024-11-20 02:47:34,1858332,39808,756,194388,15376,996656,367632,951148,317932,45508,49700,520908,358512,1267176,136336,696,1450072,20292932
2024-11-20 02:47:37,1858332,39608,756,194388,15376,996488,367632,950980,317932,45508,49700,520908,358512,1267188,136312,696,1450072,20292956
2024-11-20 02:47:39,1858332,39740,756,194388,15376,996708,367632,951200,317932,45508,49700,520908,358512,1267320,136364,696,1450072,20292912
2024-11-20 02:47:42,1858332,39392,756,194388,15376,996980,367632,951472,317932,45508,49700,520908,358512,1267676,136312,696,1450072,20293040
2024-11-20 02:47:44,1858332,39424,756,194388,15376,997160,367632,951652,317932,45508,49700,520908,358512,1267812,136312,696,1450072,20292880
2024-11-20 02:47:47,1858332,39596,756,194388,15376,997400,367632,951892,317932,45508,49700,520908,358512,1268076,136312,696,1450072,20292872
2024-11-20 02:47:49,1858332,39196,756,194388,15376,997524,367632,952016,317932,45508,49700,520908,358512,1268132,136364,696,1450072,20292980
2024-11-20 02:47:51,1858332,39288,756,194388,15376,997696,367632,952188,317932,45508,49700,520908,358512,1268080,136312,696,1450072,20293032
2024-11-20 02:47:54,1858332,38852,756,194388,15376,997512,367632,952004,317932,45508,49700,520908,358512,1268236,136300,696,1450072,20292952
2024-11-20 02:47:57,1858332,38812,756,194388,15376,998008,367632,952500,317932,45508,49700,520908,358512,1268580,136312,696,1450072,20284812
2024-11-20 02:47:59,1858332,38308,756,194388,15376,998228,367632,952720,317932,45508,49700,520908,358512,1268740,136332,696,1450072,20292792
2024-11-20 02:48:02,1858332,37916,756,194388,15376,998420,367632,952912,317932,45508,49700,520908,358512,1269128,136128,696,1450072,20292868
2024-11-20 02:48:04,1858332,38212,756,194388,15376,998480,367632,952972,317932,45508,49700,520908,358512,1269040,136180,696,1450072,20292928
2024-11-20 02:48:07,1858332,37960,756,194388,15376,998868,367632,953360,317932,45508,49700,520908,358512,1269428,136336,696,1450072,20292920
2024-11-20 02:48:09,1858332,37708,756,194388,15376,998812,367632,953304,317932,45508,49700,520908,358512,1269492,136316,696,1450072,20292944
2024-11-20 02:48:12,1858332,37328,756,194388,15376,999244,367632,953736,317932,45508,49700,520908,358512,1270016,136340,696,1450072,20293008
2024-11-20 02:48:15,1858332,37088,756,194388,15376,999576,367632,954068,317932,45508,49700,520908,358512,1270088,136316,696,1450072,20293028
2024-11-20 02:48:17,1858332,36304,756,194388,15376,1000016,367632,954508,317932,45508,49700,520908,358512,1270444,136316,696,1450072,20292964
2024-11-20 02:48:20,1858332,37504,748,191560,15376,1000768,365056,955212,318240,45556,46816,520908,358292,1271720,136192,696,1450072,20293012
2024-11-20 02:48:22,1858332,45452,748,191560,15376,992888,365056,947332,318240,45556,46816,520908,358292,1263940,136192,696,1450072,20292748
2024-11-20 02:48:25,1858332,45492,748,191560,15376,993368,365056,947812,318240,45556,46816,520908,358292,1264252,136216,696,1450072,20292892
2024-11-20 02:48:28,1858332,42692,756,191856,15376,995364,365340,949788,318240,45576,47100,520908,358292,1266136,137440,696,1450072,22213420
2024-11-20 02:48:30,1858332,42056,756,191864,15376,995868,365324,950268,318240,45600,47084,520908,358292,1266608,137588,696,1450072,22213308
2024-11-20 02:48:33,1858332,41836,756,191864,15376,996000,365324,950400,318240,45600,47084,520908,358292,1266808,137628,696,1450072,22213296
2024-11-20 02:48:35,1858332,41688,756,191864,15376,995908,365324,950308,318240,45600,47084,520908,358292,1266824,137604,696,1450072,22213288
2024-11-20 02:48:38,1858332,41436,756,191864,15376,996336,365324,950736,318240,45600,47084,520908,358292,1267332,137544,696,1450072,22213208
2024-11-20 02:48:41,1858332,40968,756,191864,15376,996840,365324,951240,318240,45600,47084,520908,358292,1267716,137604,696,1450072,22213188
2024-11-20 02:48:43,1858332,40664,756,191864,15376,997136,365324,951536,318240,45600,47084,520908,358292,1267908,137648,696,1450072,22213316
2024-11-20 02:48:46,1858332,40352,756,191864,15376,997492,365324,951892,318240,45600,47084,520908,358292,1268152,137604,696,1450072,22213292
2024-11-20 02:48:48,1858332,40248,756,191864,15376,997860,365324,952260,318240,45600,47084,520908,358292,1268740,137472,696,1450072,22213196
2024-11-20 02:48:51,1858332,40272,756,191864,15376,997820,365324,952220,318240,45600,47084,520908,358292,1268688,137604,696,1450072,22213408
2024-11-20 02:48:53,1858332,39408,756,191864,15376,998184,365324,952584,318240,45600,47084,520908,358292,1269040,137632,696,1450072,22213160
2024-11-20 02:48:56,1858332,39600,756,191864,15376,998368,365328,952768,318244,45600,47084,520908,358296,1269240,137628,696,1450072,22213392
2024-11-20 02:48:59,1858332,39192,756,191864,15376,998572,365328,952972,318244,45600,47084,520908,358300,1269512,137604,696,1450072,22213348
2024-11-20 02:49:01,1858332,39476,756,191864,15376,998624,365332,953024,318248,45600,47084,520908,358300,1269240,137580,696,1450072,22213160
2024-11-20 02:49:04,1858332,38856,756,191864,15412,998924,365460,953324,318376,45600,47084,520908,358392,1269872,137604,696,1450072,22213200
2024-11-20 02:49:06,1858332,38308,756,191864,15412,999180,365460,953580,318376,45600,47084,520908,358400,1270056,137604,696,1450072,22213412
2024-11-20 02:49:09,1858332,38384,756,191864,15412,999224,365460,953624,318376,45600,47084,520908,358400,1270336,137604,696,1450072,22213196
2024-11-20 02:49:11,1858332,38232,756,191864,15412,999376,365464,953776,318380,45600,47084,520908,358404,1270296,137420,696,1450072,22213280
2024-11-20 02:49:14,1858332,37944,756,191864,15412,999652,365464,954052,318380,45600,47084,520908,358404,1270768,137628,696,1450072,22213384
2024-11-20 02:49:17,1858332,38228,756,191864,15412,999672,365464,954072,318380,45600,47084,520908,358404,1270556,137604,696,1450072,22213168
2024-11-20 02:49:19,1858332,37752,756,191864,15412,1000144,365464,954544,318380,45600,47084,520908,358404,1271232,137624,696,1450072,22213300
2024-11-20 02:49:22,1858332,37388,756,191864,15412,999976,365464,954376,318380,45600,47084,520908,358404,1271172,137420,696,1450072,22213304
2024-11-20 02:49:24,1858332,37192,756,191864,15412,1000392,365464,954792,318380,45600,47084,520908,358404,1271328,137624,696,1450072,22213284
2024-11-20 02:49:27,1858332,37068,756,191864,15412,1000232,365464,954632,318380,45600,47084,520908,358404,1271252,137604,696,1450072,22213292
2024-11-20 02:49:29,1858332,36744,756,191864,15412,1000496,365464,954896,318380,45600,47084,520908,358404,1271508,137420,696,1450072,22213384
2024-11-20 02:49:32,1858332,36708,756,191864,15412,1000680,365464,955080,318380,45600,47084,520908,358404,1271540,137560,696,1450072,22213344
2024-11-20 02:49:35,1858332,36244,756,191864,15412,1001220,365468,955620,318384,45600,47084,520908,358408,1272516,137604,696,1450072,22213308
2024-11-20 02:49:37,1858332,36136,756,191864,15412,1001312,365468,955712,318384,45600,47084,520908,358408,1272256,137624,696,1450072,22213336
2024-11-20 02:49:40,1858332,36172,756,191864,15412,1001480,365468,955880,318384,45600,47084,520908,358408,1272496,137420,696,1450072,22213228
2024-11-20 02:49:42,1858332,36048,756,191864,15412,1001484,365468,955884,318384,45600,47084,520908,358408,1272636,137624,696,1450072,22213408
2024-11-20 02:49:45,1858332,35628,756,191864,15412,1002160,365468,956560,318384,45600,47084,520908,358408,1273324,137436,696,1450072,22213232
2024-11-20 02:49:47,1858332,41412,756,191852,15424,995404,365472,949804,318388,45600,47084,520908,358412,1266632,137436,696,1450072,22213292
2024-11-20 02:49:50,1858332,41428,756,191864,15416,995572,365484,949972,318400,45600,47084,520908,358420,1266708,137596,696,1450072,22213420
2024-11-20 02:49:52,1858332,41472,756,191864,15416,995752,365484,950152,318400,45600,47084,520908,358420,1266976,137620,696,1450072,22213224
2024-11-20 02:49:55,1858332,40876,756,191864,15416,996164,365484,950564,318400,45600,47084,520908,358420,1267152,137668,696,1450072,22213240
2024-11-20 02:49:57,1858332,41044,756,191864,15416,996188,365488,950588,318404,45600,47084,520908,358444,1267184,137620,696,1450072,22213236
2024-11-20 02:50:00,1858332,40904,756,191864,15416,996512,365488,950912,318404,45600,47084,520908,358444,1267404,137620,696,1450072,22213208
2024-11-20 02:50:03,1858332,40540,756,191864,15416,996796,365488,951196,318404,45600,47084,520908,358444,1268000,137436,696,1450072,22213256
2024-11-20 02:50:05,1858332,40472,756,191864,15416,996804,365488,951204,318404,45600,47084,520908,358444,1267888,137620,696,1450072,22213280
2024-11-20 02:50:08,1858332,39996,756,191864,15416,997024,365488,951424,318404,45600,47084,520908,358444,1268052,137644,696,1450072,22213224
2024-11-20 02:50:11,1858332,40128,756,191864,15416,996964,365488,951364,318404,45600,47084,520908,358444,1268124,137620,696,1450072,22213184
2024-11-20 02:50:13,1858332,39816,756,191864,15416,997532,365488,951932,318404,45600,47084,520908,358444,1268596,137624,696,1450072,22213224
2024-11-20 02:50:16,1858332,39720,756,191864,15416,997516,365488,951916,318404,45600,47084,520908,358444,1268704,137580,696,1450072,22213224
2024-11-20 02:50:18,1858332,38708,756,191864,15416,997808,365488,952208,318404,45600,47084,520908,358444,1268724,137620,696,1450072,22213444
2024-11-20 02:50:20,1858332,38748,756,191864,15416,997744,365488,952144,318404,45600,47084,520908,358444,1268692,137620,696,1450072,22213444
2024-11-20 02:50:22,1858332,38556,756,191864,15416,997640,365488,952040,318404,45600,47084,520908,358444,1268684,137436,696,1450072,22213336
2024-11-20 02:50:25,1858332,37464,756,191860,15420,998480,365488,952880,318404,45600,47084,520908,358448,1269556,137620,696,1450072,22213488
2024-11-20 02:50:27,1858332,37632,756,191864,15420,998828,365496,953228,318412,45600,47084,520908,358448,1269780,137620,696,1450072,22213344
2024-11-20 02:50:29,1858332,44076,792,193720,15736,993604,364832,947692,316384,45912,48448,520908,358352,1262440,137988,696,1450072,20156860
2024-11-20 02:50:31,1858332,40544,832,195668,15808,996440,366312,950004,316180,46436,50132,520908,358384,1264400,137800,696,1450072,22074736
2024-11-20 02:50:33,1858332,40784,832,194932,15808,996180,365860,949744,316568,46436,49292,520908,358368,1264416,137812,696,1450072,22074788
2024-11-20 02:50:35,1858332,46984,840,192736,15808,991720,363712,945264,316516,46456,47196,520908,358256,1259880,137800,696,1450072,22074756
2024-11-20 02:50:37,1858332,46856,840,192748,15808,992032,363720,945572,316528,46460,47192,520908,358256,1260180,137868,696,1450072,22074704
2024-11-20 02:50:39,1858332,47860,840,192756,15812,991168,363732,944708,316532,46460,47200,520908,358256,1259192,137868,696,1450072,22074740
2024-11-20 02:50:42,1858332,47960,844,192752,15812,991324,363732,944864,316532,46460,47200,520908,358256,1259624,137884,696,1450072,22074592
2024-11-20 02:50:44,1858332,47552,844,192756,15812,991576,363736,945116,316532,46460,47204,520908,358256,1259752,137868,696,1450072,22074680
2024-11-20 02:50:46,1858332,47628,844,192756,15812,991824,363748,945364,316544,46460,47204,520908,358268,1260000,137868,696,1450072,22074660
2024-11-20 02:50:48,1858332,47860,844,192756,15812,991760,363748,945300,316544,46460,47204,520908,358268,1260168,137868,696,1450072,22074756
2024-11-20 02:50:50,1858332,47608,844,192756,15812,992084,363748,945624,316544,46460,47204,520908,358268,1260256,137868,696,1450072,22074800
2024-11-20 02:50:52,1858332,47616,844,192756,15812,992076,363748,945616,316544,46460,47204,520908,358268,1260252,137868,696,1450072,22074932
